100000000000001;100000000000001;100000000000001;100000000000001;100000000000001;100000000000001;100000000000001;100000000000001;100000000000001;100000000000001;100000000000001;100000000000001;100000000000001;100000000000001;100000000000001;100000000000001;100000000000001;100000000000001;100000000000001;100000000000001;100000000000001;100000000000001;100000000000001;100000000000001;100000000000001;100000000000001;100000000000001;100000000000001;100000000000001;
100000000000001;100000000000001;100000000000001;100000000000001;100000000000001;100000000000001;100000000000001;100000000000001;100000000000001;100000000000001;100000000000001;100000000000008;0;100000000000001;D0000000000;C0000000000;E0000000000;0;0;0;0;0;0;0;0;0;0;0;100000000000001;
100000000000001;100000000000001;100000000000001;100000000000001;100000000000001;100000000000001;100000000000001;100000000000001;100000000000001;100000000000008;0;0;0;100000000000009;D0000000000;C0000000000;E0000000000;0;0;0;201000000000004;0;0;0;0;0;0;290000000000;100000000000001;
100000000000001;100000000000001;100000000000001;100000000000001;100000000000001;100000000000001;100000000000001;100000000000008;170000000000;180000000000;0;290000000000;0;0;D0000000000;C0000000000;E0000000000;0;0;0;0;0;0;0;0;0;0;202280000000001;100000000000001;
100000000000001;3E0000000000;3E0000000000;0;0;0;0;20000000000000B;D0000000000;E0000000000;0;200280000000001;0;0;D0000000000;C0000000000;E0000000000;0;290000000000;0;0;0;0;0;0;290000000000;0;100000000000003;100000000000001;
100000000000001;3B0000000000;3B0000000000;290000000000;0;0;0;0;D0000000000;E0000000000;100000000000015;100000000000015;0;0;1000D0000000000;C0000000000;2020E0000000004;0;202280000000001;0;100000000000000;100000000000000;0;200000000000004;0;202280000000001;0;100000000000001;100000000000001;
100000000000001;3003B0000000002;3B0000000000;200280000000001;0;200000000000004;0;0;1000D0000000000;E0000000000;0;0;0;100000000000015;D0000000000;1000C0000000005;1000E0000000002;100000000000002;100000000000002;100000000000006;0;0;100000000000005;100000000000002;100000000000002;100000000000002;100000000000002;100000000000001;100000000000001;
100000000000001;100000000000002;100000000000002;100000000000002;100000000000002;100000000000002;100000000000002;100000000000006;D0000000000;E0000000000;100000000000015;100000000000015;0;0;D0000000000;150000000000;180000000000;0;0;0;0;0;0;0;0;0;0;0;100000000000001;
100000000000001;2002B0000000000;2002B0000000000;1003D000000000E;10000000000000E;10000000000000E;10000000000000E;10000000000000E;D0000000000;100180000000015;0;0;0;10000000000000C;D0000000000;C0000000000;E0000000000;0;290000000000;0;0;0;0;0;0;290000000000;0;0;100000000000001;
100000000000001;2002B0000000003;2002B0000000003;1003D000000000E;10000000000000E;10000000000000E;10000000000000E;10000000000000E;D0000000000;E0000000000;0;0;0;100000000000001;D0000000000;C0000000000;E0000000000;0;200280000000001;0;0;0;0;0;0;200280000000001;0;0;100000000000001;
100000000000001;2B0000000000;1002B0000000015;100000000000003;100000000000002;100000000000002;100000000000002;100000000000002;100000000000002;100000000000004;0;10000000000000C;0;100000000000001;1000C0000000004;C0000000000;E0000000000;100000000000015;100000000000015;100000000000015;100000000000015;100000000000015;100000000000015;100000000000015;100000000000015;100000000000015;100000000000015;0;100000000000001;
100000000000001;2002B0000000000;2002B0000000000;1003B0000000007;100000000000001;100000000000001;100000000000001;100000000000001;100000000000001;1003B0000000008;2B0000000000;1003B0000000009;2B0000000000;1002B0000000001;1000C0000000001;C0000000000;E0000000000;0;102000000000000;0;200000000000004;0;0;102000000000000;0;0;200000000000004;0;100000000000001;
100000000000001;1002B0000000015;2002B0000000002;2B0000000000;2002B0000000000;2002B0000000000;2B0000000000;2002B0000000003;2002B0000000003;2002B0000000003;2B0000000000;2B0000000000;2B0000000000;1002B0000000001;100000000000001;100000000000002;100000000000002;100000000000004;0;100000000000003;100000000000004;200000000000000;0;200000000000000;100000000000003;100000000000002;100000000000002;100000000000002;100000000000001;
100000000000001;2B0000000000;2B0000000000;2B0000000000;2B0000000000;2B0000000000;2B0000000000;2B0000000000;2B0000000000;2B0000000000;2B0000000000;2B0000000000;2B0000000000;100000000000001;100000000000001;100000000000001;100000000000001;100000000000001;0;100000000000001;100000000000001;200000000000000;100000000000015;200000000000000;100000000000001;100000000000001;100000000000001;100000000000001;100000000000001;
100000000000001;3B0000000000;1003B000000640F;1003B000000640F;1003B000000640F;1003B000000640F;1003B000000640F;1003B000000640F;1003B000000640F;1003B000000640F;1003B000000640F;3B0000000000;1003B0000000015;100000000000001;100000000000001;100000000000001;100000000000001;100000000000001;0;100000000000001;100000000000001;200000000000000;0;200000000000000;100000000000001;100000000000001;100000000000001;100000000000001;100000000000001;
100000000000001;3B0000000000;3B0000000000;3B0000000000;3B0000000000;3B0000000000;3B0000000000;3B0000000000;3B0000000000;3B0000000000;3B0000000000;2003B0000000003;2003B0000000003;100000000000001;100000000000001;100000000000001;100000000000001;100000000000008;0;100000000000007;100000000000008;200000000000000;100000000000015;200000000000000;100000000000007;100000000000001;100000000000001;100000000000001;100000000000001;
100000000000001;1003B000000001C;1003B000000001C;1003B000000001C;1003B000000001C;1003B000000001C;1003B000000001C;1003B000000001C;1003B000000001C;1003B000000001C;1003B000000001C;1003B0000000003;100000000000002;100000000000008;0;0;0;20000000000000B;0;100000000000000;0;200000000000000;0;200000000000000;0;0;0;2D0000000000;1002D0000000001;
100000000000001;100000000000002;100000000000002;100000000000002;100000000000002;100000000000002;100000000000002;100000000000002;100000000000002;100000000000002;100000000000002;100000000000008;0;0;0;100000000000000;0;0;0;390000000000;0;0;100000000000015;0;0;290000000000;0;2D0000000000;1000C0000000001;
100000000000001;100000000000001;100000000000001;100000000000001;100000000000001;100000000000001;100000000000001;100000000000001;100000000000008;0;170000000000;140000000000;0;0;0;0;0;0;0;380000000000;102000000000000;0;0;202000000000004;0;202280000000001;202000000000003;2022D0000000003;100000000000001;
100000000000001;2C0000000000;20000000000000B;0;0;0;0;0;0;0;D0000000000;E0000000000;0;0;0;204000000000004;0;0;0;20038000000000C;0;100000000000005;104000000000002;104000000000002;104000000000002;104000000000002;104000000000002;104000000000002;100000000000001;
100000000000001;2C0000000000;0;0;0;0;0;0;0;204000000000004;D0000000000;E0000000000;204000000000004;0;0;0;0;0;0;3A0000000000;0;0;10000000000000E;10000000000000E;200000000000000;200000000000000;200290000000000;2002D0000000000;100000000000001;
100000000000001;2C0000000000;0;0;0;0;0;0;0;0;D0000000000;E0000000000;0;0;0;0;0;0;0;100000000000000;0;0;10000000000000E;10000000000000E;200000000000004;0;200280000000001;2D0000000000;100000000000001;
100000000000001;2C0000000000;0;0;0;0;0;10000000000000A;0;0;1000D000000000A;E0000000000;0;10000000000000A;0;0;10000000000000A;0;0;100000000000005;100000000000002;100000000000002;100000000000002;1000D0000000002;100000000000002;100000000000002;100000000000002;1000D0000000002;100000000000001;
100000000000001;2C0000000000;290000000000;0;100000000000015;100000000000015;0;0;0;0;170000000000;E0000000000;100000000000000;0;0;100000000000000;0;0;0;0;0;170000000000;180000000000;0;0;0;3C0000000000;3B0000000000;1002D0000000001;
100000000000001;2C0000000000;200280000000001;0;0;0;0;200000000000009;0;0;D0000000000;E0000000000;0;0;0;0;0;0;0;0;0;D0000000000;E0000000000;0;0;0;3C0000000000;3B0000000000;100000000000001;
100000000000001;1002C0000000002;100000000000002;100000000000002;100000000000006;0;0;0;0;0;D0000000000;E0000000000;0;290000000000;0;0;0;0;0;2E0000000000;2F0000000000;D0000000000;E0000000000;0;0;100000000000000;3C0000000000;3B0000000000;100000000000001;
100000000000001;2C0000000000;0;0;10000000000000E;10000000000000E;0;100000000000015;0;100000000000000;D0000000000;E0000000000;0;200280000000001;0;200000000000004;100000000000000;100000000000000;20F000000000012;300000000000;310000000000;2000D0000000004;1000E0000000000;0;0;200390000000000;3C0000000000;2003B0000000003;100000000000001;
100000000000001;2002C0000000000;200000000000000;200000000000000;10000000000000E;10000000000000E;0;0;0;0;100000000000005;100080000000002;100080000000002;100000000000002;100000000000002;100000000000006;0;0;100000000000005;100000000000002;100000000000002;1000D0000000002;100000000000006;100000000000000;0;200380000000000;3C0000000000;1003B0000000005;100000000000001;
100000000000001;2002C0000000000;200290000000000;200000000000000;10000000000000E;10000000000000E;0;100000000000015;0;0;170000000000;180000000000;0;0;0;0;0;0;0;0;0;170000000000;140000000000;390000000000;0;200380000000000;3C0000000000;3B0000000000;100000000000001;
100000000000001;2C0000000000;200280000000001;200000000000004;10000000000000E;10000000000000E;200000000000003;0;0;0;D0000000000;E0000000000;0;0;0;0;0;0;0;201000000000004;0;D0000000000;E0000000000;380000000000;0;200380000000000;3C0000000000;2003B0000000003;100000000000001;
100000000000001;100000000000002;100000000000002;100000000000002;100000000000002;100000000000002;100000000000002;100000000000002;100000000000006;0;D0000000000;E0000000000;320000000000;330000000000;0;0;0;0;0;0;0;D0000000000;E0000000000;380000000000;0;200380000000000;3C0000000000;1003B0000000005;100000000000001;
100000000000001;150000000000;150000000000;150000000000;140000000000;0;170000000000;150000000000;180000000000;0;D0000000000;E0000000000;340000000000;350000000000;0;0;200000000000003;0;0;0;290000000000;D0000000000;E0000000000;20038000000000C;0;200380000000000;3C0000000000;3B0000000000;100000000000001;
100000000000001;C0000000000;C0000000000;C0000000000;E0000000000;0;D0000000000;110000000000;E0000000000;0;D0000000000;E0000000000;360000000000;370000000000;100000000000000;0;0;0;200000000000004;0;200280000000001;D0000000000;1000E0000000000;3A0000000000;0;200380000000000;3C0000000000;2003B0000000003;100000000000001;
100000000000001;C0000000000;210000000000;220000000000;E0000000000;0;D0000000000;110000000000;E0000000000;0;D0000000000;E0000000000;100000000000003;100000000000004;10000000000001C;100000000000003;100080000000002;100080000000002;100000000000002;100000000000002;100000000000002;100000000000002;100000000000004;100000000000000;0;2003A000000000C;3C0000000000;1003B0000000005;100000000000001;
100000000000001;C0000000000;230000000000;240000000000;2000E0000000000;200000000000000;D0000000000;110000000000;E0000000000;0;D0000000000;20E0E0000000012;100000000000001;100000000000001;100000000000002;100000000000001;100000000000001;100000000000001;100000000000001;100000000000001;100000000000001;100000000000001;100000000000001;3B0000000000;3B0000000000;1003B0000000000;3B0000000000;3B0000000000;100000000000001;
100000000000001;3000C0000000001;C0000000000;C0000000000;E0000000000;0;D0000000000;2000C0000000004;E0000000000;0;D0000000000;100000000000003;100000000000001;100000000000001;100000000000001;100000000000001;100000000000001;100000000000001;100000000000001;100000000000001;100000000000001;100000000000001;100000000000001;1003B000000001C;1003B000000001C;1003B000000001C;1003B000000001C;1003B000000001C;100000000000001;
100000000000001;100000000000002;100000000000002;100000000000002;100000000000002;100000000000002;100000000000002;100000000000002;100000000000002;100080000000002;1000D0000000002;100000000000001;100000000000001;100000000000001;100000000000001;100000000000001;100000000000001;100000000000001;100000000000001;100000000000001;100000000000001;100000000000001;100000000000001;100000000000001;100000000000001;100000000000001;100000000000001;100000000000001;100000000000001;
