0;100000000000001;100000000000001;100000000000001;100000000000001;100000000000001;100000000000001;100000000000001;100000000000001;100000000000001;100000000000001;100000000000001;100000000000001;100000000000001;100000000000001;100000000000001;100000000000001;100000000000001;100000000000001;100000000000001;100000000000001;100000000000001;100000000000001;100000000000001;100000000000001;100000000000001;100000000000001;100000000000001;100000000000001;100000000000001;100000000000001;100000000000001;100000000000001;100000000000001;100000000000001;100000000000001;100000000000001;100000000000001;
100000000000001;3F0000000000;3F0000000000;3F0000000000;200400000000000;200000000000000;0;0;0;0;0;200000000000000;200000000000000;0;200000000000000;200000000000000;0;D0000000000;1000C0000000001;1000C0000000001;1003F0000000001;E0000000000;0;0;0;0;0;201000000000004;0;0;0;0;250000000000;0;0;100000000000001;100000000000001;100000000000001;
100000000000001;3F0000000000;3F0000000000;3F0000000000;200400000000000;200000000000000;0;0;0;0;0;200000000000000;200000000000000;0;200000000000000;200000000000000;0;D0000000000;1000C0000000001;1000C0000000001;1000C0000000008;E0000000000;0;0;0;0;0;0;0;290000000000;0;0;250000000000;100000000000000;0;100000000000007;100000000000001;100000000000001;
100000000000001;2003F0000000006;3F0000000000;3F0000000000;200400000000003;200000000000003;0;0;0;0;0;0;0;0;0;0;0;D0000000000;1000C0000000007;1000C0000000008;150000000000;2010E0000000009;0;0;101000000000000;0;200000000000004;0;0;201280000000001;0;100000000000000;250000000000;390000000000;0;0;100000000000001;100000000000001;
100000000000001;1003F0000000015;3F0000000000;3F0000000000;100400000000015;100000000000015;200000000000000;200000000000000;200290000000000;200000000000000;200000000000000;100000000000015;100000000000015;0;100000000000015;100000000000015;0;2000D0000000004;150000000000;101150000000017;C0000000000;2000E0000000004;101000000000000;100000000000015;0;100000000000003;100000000000002;100000000000002;100000000000002;100000000000002;100000000000004;204000000000004;250000000000;380000000000;0;0;0;100000000000001;
100000000000001;3F0000000000;3F0000000000;3F0000000000;400000000000;0;0;0;200280000000001;0;0;0;0;0;0;0;0;100000000000003;1000C0000000002;1000C0000000002;1000C0000000002;100000000000004;100000000000010;100000000000010;100000000000010;100000000000001;100000000000001;100000000000001;100000000000001;100000000000001;100000000000001;0;250000000000;20038000000000C;204000000000003;204000000000003;0;100000000000001;
100000000000001;3F0000000000;3F0000000000;3F0000000000;400000000000;0;100000000000015;100000000000015;100000000000015;100000000000015;100000000000015;0;0;0;0;0;0;100000000000001;100000000000001;100000000000001;100000000000001;100000000000001;100000000000002;100000000000002;100000000000001;100000000000001;100000000000001;100000000000001;100000000000001;100000000000001;100000000000008;0;250000000000;380000000000;0;100000000000000;0;100000000000001;
100000000000001;3003F0000000001;3F0000000000;3F0000000000;400000000000;210000000000012;0;0;0;0;0;0;0;0;200000000000004;0;1003F0000000003;100000000000001;0;20000000000000B;0;0;0;0;100000000000001;100000000000001;0;0;0;0;10000000000000E;0;250000000000;380000000000;0;0;0;100000000000001;
100000000000001;100000000000002;100000000000002;100000000000002;100000000000002;100000000000002;100000000000002;100000000000002;100000000000002;100000000000002;100000000000002;100000000000002;100000000000002;100000000000002;100000000000002;100000000000002;100000000000001;100000000000001;0;0;0;200000000000000;200000000000000;200000000000000;100000000000001;100000000000001;0;200000000000000;200000000000000;0;10000000000000E;104000000000000;250000000000;380000000000;0;0;0;100000000000001;
100000000000001;100000000000001;100000000000001;100000000000001;100000000000001;100000000000001;100000000000001;100000000000001;0;0;0;10000000000000E;0;0;0;0;0;100000000000001;0;0;0;200000000000000;200290000000000;200000000000000;100000000000001;100000000000001;0;200290000000000;200000000000000;0;10000000000000E;0;250000000000;380000000000;0;0;200000000000009;100000000000001;
100000000000001;0;0;20000000000000B;0;0;100000000000001;100000000000001;290000000000;0;0;10000000000000E;0;200000000000000;0;200000000000007;0;100000000000001;0;0;0;0;200280000000001;0;100000000000001;100000000000001;0;200280000000001;200000000000003;0;10000000000000E;0;250000000000;380000000000;0;204000000000004;200000000000009;100000000000001;
100000000000001;0;0;0;0;0;100000000000001;100000000000001;200280000000001;0;200000000000004;10000000000000E;100000000000000;0;200000000000003;10000000000000C;0;100000000000001;0;0;100000000000015;100000000000003;100000000000002;100000000000002;100000000000001;100000000000001;100000000000002;100000000000002;100000000000002;100000000000002;100250000000004;0;10025000000000C;380000000000;10000000000000C;0;100000000000015;100000000000001;
100000000000001;0;200000000000000;200000000000000;200000000000000;0;100000000000007;100000000000001;100000000000002;100000000000002;100000000000002;100000000000004;0;10000000000000C;200000000000003;100000000000001;0;100000000000001;0;0;0;100000000000001;200290000000000;200000000000000;200000000000003;0;0;200000000000000;200000000000000;200000000000000;100250000000001;0;100250000000001;380000000000;100000000000001;0;0;100000000000001;
100000000000001;200000000000003;200000000000000;200000000000000;200000000000000;0;0;0;0;0;10000000000000E;100000000000009;0;100000000000001;200000000000003;100000000000001;0;100000000000001;200000000000005;0;100000000000015;100000000000001;200280000000001;200000000000000;200000000000003;0;0;200000000000000;200030000000000;200000000000000;100250000000001;0;100250000000001;380000000000;100000000000001;0;0;100000000000001;
100000000000001;0;0;0;0;0;0;0;0;0;10000000000000E;10000000000000E;0;100000000000001;200000000000003;100000000000001;0;100000000000009;100000000000015;0;0;100000000000007;100000000000002;100000000000002;100000000000006;0;0;100000000000005;100000000000002;100000000000002;100000000000008;0;100250000000009;380000000000;100000000000009;100000000000000;0;100000000000001;
100000000000001;0;100000000000003;100000000000006;0;0;0;0;0;0;10000000000000E;10000000000000E;0;100000000000001;0;100000000000001;0;0;0;0;100000000000015;0;0;0;0;100000000000015;0;0;0;0;0;0;250000000000;380000000000;0;0;0;100000000000001;
100000000000001;0;100000000000001;0;100000000000015;0;0;0;0;0;10000000000000E;10000000000000E;0;100000000000009;0;100000000000009;0;0;0;200000000000000;0;0;0;0;0;0;100000000000015;0;0;0;0;0;250000000000;3A0000000000;0;0;0;100000000000001;
100000000000001;0;100000000000001;0;200000000000004;0;200000000000004;30000000000;200000000000004;0;10000000000000E;10000000000000E;0;0;211000000000012;0;0;30000000000;200000000000000;100000000000015;0;30000000000;0;30000000000;0;0;0;0;30000000000;0;30000000000;0;250000000000;10000000000000C;10000000000001C;10000000000001C;10000000000001C;100000000000001;
100000000000001;0;100000000000001;100000000000002;100000000000002;100000000000002;100000000000002;100000000000002;100000000000002;100000000000002;100000000000002;100000000000002;100000000000002;100000000000002;100250000000002;100000000000002;100000000000002;100000000000004;200000000000000;200000000000000;0;100000000000003;100000000000002;100000000000002;100000000000004;100000000000015;0;100000000000003;100000000000002;100000000000002;100000000000002;100000000000002;100250000000002;100000000000001;100000000000002;100000000000002;100000000000002;100000000000001;
100000000000001;0;100000000000009;0;0;0;0;0;0;0;0;0;0;20000000000000B;0;100000000000001;100000000000001;100000000000001;200000000000000;100000000000015;0;100000000000001;100000000000001;100000000000001;100000000000001;100000000000010;100000000000010;100000000000001;100000000000001;100000000000001;100000000000001;100000000000001;100250000000001;100000000000001;100000000000001;100000000000001;100000000000001;100000000000001;
100000000000001;0;0;0;0;0;204000000000004;204000000000000;0;0;0;0;0;0;0;100000000000001;100000000000001;100000000000001;200000000000000;0;0;100000000000001;100000000000001;100000000000001;100000000000001;100000000000002;100000000000002;100000000000001;0;0;0;0;250000000000;0;0;0;290000000000;100000000000001;
100000000000001;100000000000002;100000000000002;100000000000002;100000000000004;0;0;204000000000000;204000000000004;204000000000000;0;0;0;0;0;100250000000007;100000000000001;100000000000001;100000000000004;100000000000010;100000000000010;100000000000001;100000000000001;100000000000001;100000000000001;100000000000001;100000000000001;100000000000008;0;0;0;0;250000000000;0;0;0;200280000000001;100000000000001;
100000000000001;100000000000001;100000000000001;100250000000001;100000000000001;0;10000000000000C;0;0;204000000000000;204000000000004;0;0;0;0;0;104000000000018;0;100000000000007;100000000000002;100000000000002;100000000000001;100000000000001;100000000000001;100000000000008;0;0;0;0;0;0;201000000000004;250000000000;200000000000003;0;100000000000015;100000000000015;100000000000001;
100000000000001;100000000000001;100000000000001;100000000000001;100000000000001;10000000000001C;100000000000001;0;10000000000000C;0;0;0;0;290000000000;0;0;10000000000000C;0;0;0;0;0;170000000000;140000000000;0;0;0;0;0;0;0;0;250000000000;200000000000003;0;0;200000000000003;100000000000001;
100000000000001;100000000000001;100000000000001;100000000000001;100000000000001;100000000000001;100000000000001;10000000000001C;100000000000001;0;10000000000000C;0;0;200280000000001;0;219000000000012;100000000000001;100000000000015;202000000000003;202000000000003;0;0;D0000000000;E0000000000;0;200000000000000;0;200000000000000;0;200000000000000;0;200000000000000;250000000000;200000000000003;0;100000000000015;100290000000015;100000000000001;
100000000000001;3E0000000000;3E0000000000;3E0000000000;3D0000000000;0;100000000000007;100000000000001;100000000000001;10000000000001C;100000000000001;0;100000000000003;100000000000002;100250000000002;100000000000002;100000000000001;0;30000000000;0;202000000000004;30000000000;D0000000000;E0000000000;102000000000000;0;0;0;0;0;0;0;250000000000;0;0;0;200280000000001;100000000000001;
100000000000001;3B0000000000;3B0000000000;2003B0000000000;2003D0000000000;0;0;0;100000000000007;100000000000001;100000000000001;10000000000001C;100000000000001;100000000000001;100000000000001;100000000000001;100000000000001;100000000000002;100000000000002;100000000000002;100000000000002;100000000000002;1000D0000000002;1000E0000000006;0;10000000000000A;0;10000000000000A;0;10000000000000A;0;10000000000000A;250000000000;10000000000000A;0;100000000000005;100000000000002;100000000000001;
100000000000001;3003B0000000002;3B0000000000;3B0000000000;3D0000000000;0;0;0;0;0;100000000000007;100000000000002;100000000000008;0;0;0;0;0;0;0;0;0;170000000000;180000000000;0;0;0;0;0;0;0;0;250000000000;0;0;0;0;100000000000001;
100000000000001;1003B0000000002;1003B0000000004;3B0000000000;1003D000000000C;320000000000;330000000000;0;0;0;0;0;0;0;200000000000000;320000000000;200330000000000;290000000000;200320000000000;330000000000;102000000000000;0;2020D0000000004;1020E0000000000;0;0;0;0;0;0;0;290000000000;250000000000;0;100000000000015;320000000000;330000000000;100000000000001;
100000000000001;100000000000001;100000000000001;1003B000000001C;1003D0000000001;340000000000;350000000000;200000000000004;30000000000;0;200000000000004;30000000000;0;200000000000004;0;340000000000;350000000000;200280000000001;340000000000;350000000000;0;100000000000003;1000D0000000004;E0000000000;0;200000000000004;0;0;200000000000004;30000000000;0;200280000000001;270000000000;0;200000000000004;340000000000;350000000000;100000000000001;
100000000000001;100000000000001;100000000000001;100000000000001;1003D0000000001;100000000000002;100000000000002;100000000000002;100000000000002;100000000000002;100000000000002;100000000000002;100000000000002;100000000000002;100000000000002;100000000000002;100000000000002;100000000000002;100000000000002;100000000000002;100000000000002;100000000000001;100000000000001;100000000000002;100000000000002;100000000000002;100000000000002;100000000000002;100000000000002;100000000000002;100000000000002;100000000000002;100000000000002;100000000000002;100000000000002;100000000000002;100000000000002;100000000000001;
