0;100000000000001;100000000000001;100000000000001;100000000000001;100000000000001;100000000000001;100000000000001;100000000000001;100000000000001;100000000000001;100000000000001;100000000000001;100000000000001;100000000000001;100000000000001;100000000000001;100000000000001;100000000000001;100000000000001;100000000000001;100000000000001;100000000000001;100000000000001;100000000000001;100000000000001;100000000000001;100000000000001;100000000000001;100000000000001;100000000000001;100000000000001;100000000000001;100000000000001;100000000000001;100000000000001;100000000000001;100000000000001;
100000000000001;100000000000001;100000000000001;100000000000001;0;0;0;0;0;0;170000000000;150000000000;150000000000;140000000000;0;0;100000000000001;100000000000001;100000000000001;0;0;0;0;0;0;20000000000000D;0;0;0;0;0;0;0;0;0;0;0;100000000000001;
100000000000001;100000000000001;100000000000001;100000000000008;0;0;0;0;0;201000000000004;D0000000000;C0000000000;C0000000000;E0000000000;0;0;100000000000007;100000000000001;100000000000008;0;A0000000000;0;0;200000000000009;0;200000000000009;0;200000000000009;0;200000000000009;0;0;0;0;0;290000000000;0;100000000000001;
100000000000001;100000000000001;100000000000008;0;0;0;0;0;0;0;D0000000000;C0000000000;C0000000000;E0000000000;0;0;3C0000000000;1003B0000000018;3D0000000000;0;90000000000;0;0;0;0;0;0;0;0;0;100000000000000;0;203000000000004;0;A0000000000;200280000000001;B0000000000;100000000000001;
100000000000001;0;20000000000000B;0;0;0;0;0;0;0;D0000000000;C0000000000;C0000000000;E0000000000;204000000000004;0;100000000000003;100000000000002;100000000000002;100000000000002;100000000000006;100000000000015;0;10000000000001A;0;10000000000001A;0;10000000000001A;0;10000000000001A;0;100000000000003;100000000000002;100000000000002;100000000000002;100000000000002;100000000000002;100000000000001;
100000000000001;0;0;0;104000000000015;0;10400000000000E;10400000000000E;10400000000000E;10400000000000E;1040D000000000E;1040C000000000E;C0000000000;E0000000000;0;0;100000000000001;100000000000001;100000000000001;0;0;0;0;0;0;0;0;0;0;0;0;100000000000001;100000000000001;100000000000001;100000000000001;100000000000001;100000000000001;100000000000001;
100000000000001;0;0;0;0;0;10400000000000E;204000000000003;204000000000003;204000000000003;2040D0000000003;1040C000000000E;C0000000000;E0000000000;0;100000000000003;100000000000001;100000000000001;100000000000001;201000000000000;0;100000000000015;0;0;0;0;0;0;0;0;0;100000000000001;100000000000001;0;100000000000000;170000000000;150000000000;100000000000001;
100000000000001;0;0;0;104290000000015;10000000000000C;10400000000000E;10402000000000E;10400000000000E;10400000000000E;1040D000000000E;1040C000000000E;1000C000000000C;1000E0000000010;100000000000003;100000000000001;100000000000001;100000000000001;100000000000001;201000000000000;0;0;0;0;0;0;0;0;0;0;0;100000000000001;100000000000008;0;390000000000;D0000000000;3000C0000000002;100000000000001;
100000000000001;0;0;0;201280000000001;100000000000001;100000000000002;100000000000002;100000000000002;100000000000002;1000D0000000002;100000000000002;100000000000001;100000000000002;100000000000001;100000000000001;100000000000001;100000000000001;100000000000001;201000000000000;0;10000000000000C;100000000000010;100000000000010;100000000000010;100000000000010;100000000000010;100000000000010;100000000000010;100000000000010;100000000000010;100000000000001;0;0;380000000000;2040D0000000004;100150000000015;100000000000001;
100000000000001;290000000000;0;104000000000015;104000000000015;100000000000001;0;0;0;0;170000000000;201150000000004;150000000000;180000000000;0;0;0;100000000000001;100000000000001;100000000000015;0;100000000000007;100000000000002;100000000000002;100000000000002;100000000000002;100000000000002;100000000000002;100000000000002;100000000000002;100000000000002;100000000000008;0;204000000000004;20038000000000C;D0000000000;C0000000000;100000000000001;
100000000000001;204280000000001;0;201000000000000;0;100000000000009;0;0;0;0;D0000000000;C0000000000;C0000000000;E0000000000;0;0;0;100000000000001;100000000000001;50000000000;0;0;0;0;0;0;0;0;0;0;0;290000000000;0;0;3A0000000000;D0000000000;C0000000000;100000000000001;
100000000000001;100000000000015;100000000000015;201000000000000;0;0;0;0;0;0;D0000000000;C0000000000;C0000000000;E0000000000;0;0;0;100000000000007;100000000000001;100000000000002;100000000000004;0;0;100000000000000;0;0;0;203000000000004;0;0;B0000000000;203280000000001;A0000000000;0;100000000000000;D0000000000;C0000000000;100000000000001;
100000000000001;0;201000000000000;201000000000000;0;0;204000000000004;0;0;290000000000;D0000000000;C0000000000;C0000000000;E0000000000;290000000000;0;0;0;100000000000007;100000000000001;100000000000001;100000000000002;100000000000004;10000000000001C;100000000000003;100000000000002;100000000000002;100000000000002;100000000000002;100000000000002;100000000000002;100000000000002;100000000000002;100000000000002;100000000000002;100000000000002;100000000000002;100000000000001;
100000000000001;0;100000000000015;0;0;0;0;105000000000000;0;200280000000001;D0000000000;2050C0000000004;C0000000000;2050E0000000004;200280000000001;0;105000000000000;0;0;0;0;0;100000000000007;100000000000002;100000000000008;170000000000;150000000000;180000000000;0;0;0;0;0;0;0;0;170000000000;100000000000001;
100000000000001;10000000000;0;0;0;0;0;0;100000000000015;100000000000015;100170000000015;100150000000015;100150000000015;100140000000015;100000000000015;100000000000015;0;0;0;0;20000000000000D;0;0;0;100000000000017;D0000000000;C0000000000;E0000000000;200000000000009;200000000000009;200000000000005;0;200000000000003;200000000000003;0;0;D0000000000;100000000000001;
100000000000001;100000000000002;100000000000004;0;10000000000000C;0;100000000000015;0;0;0;D0000000000;C0000000000;C0000000000;E0000000000;0;0;204000000000003;0;104000000000015;0;0;0;217000000000012;100000000000003;100000000000002;1000D0000000004;C0000000000;E0000000000;0;0;0;0;200000000000000;200000000000000;0;0;D0000000000;100000000000001;
100000000000001;100000000000001;100000000000001;0;100000000000001;0;0;0;0;203000000000003;2030D0000000003;C0000000000;C0000000000;E0000000000;203000000000003;203000000000003;104000000000015;0;0;104000000000015;0;100000000000003;100000000000002;100000000000001;100000000000001;1000D0000000001;100000000000002;1000E0000000004;10000000000001C;10000000000001C;100000000000003;100000000000004;200000000000000;200000000000000;0;100000000000000;D0000000000;100000000000001;
100000000000001;100000000000001;100000000000001;10000000000001C;100000000000001;0;100000000000015;0;10000000000;0;D0000000000;130000000000;200110000000007;E0000000000;0;0;203000000000004;10000000000;0;0;100000000000003;100000000000001;100000000000001;100000000000001;100000000000001;100000000000001;100000000000001;100000000000001;100000000000002;100000000000002;100000000000001;100000000000001;100000000000002;100000000000006;0;390000000000;D0000000000;100000000000001;
100000000000001;1003B0000000001;1003B0000000001;100000000000002;100000000000001;100000000000002;100000000000002;100000000000002;100000000000002;100000000000002;100000000000002;100000000000002;100000000000002;100000000000002;100000000000002;100000000000002;100000000000002;100000000000002;100000000000002;100000000000002;100000000000001;100000000000001;100000000000008;0;0;0;0;0;0;0;0;0;0;0;0;380000000000;D0000000000;100000000000001;
100000000000001;3B0000000000;3B0000000000;3B0000000000;3B0000000000;2003B0000000000;2003B0000000000;2003B0000000000;2003B0000000000;2003B0000000000;2003B0000000000;3D0000000000;0;10000000000000E;10000000000000E;0;0;170000000000;150000000000;140000000000;0;0;0;0;0;0;0;0;0;0;0;0;0;0;0;20038000000000C;D0000000000;100000000000001;
100000000000001;3B0000000000;3B0000000000;3B0000000000;3B0000000000;2003B0000000000;2003B0000000000;2003B0000000000;2003B0000000000;2003B0000000000;2003B0000000000;3D0000000000;0;10000000000000E;10000000000000E;0;100000000000000;D0000000000;C0000000000;E0000000000;0;0;0;0;0;0;0;0;10000000000000A;0;0;0;0;0;0;380000000000;D0000000000;100000000000001;
100000000000001;2003B0000000003;2003B0000000003;3B0000000000;3B0000000000;1003B0000000015;1003B0000000015;1003B0000000015;1003B0000000015;1003B0000000015;1003B0000000015;3D0000000000;0;10000000000000E;10000000000000E;0;390000000000;D0000000000;C0000000000;E0000000000;100000000000000;0;212000000000012;10000000000;0;0;0;0;20000000000000B;0;0;10000000000000A;0;0;0;3A0000000000;D0000000000;100000000000001;
100000000000001;2003B0000000003;2003B0000000003;3B0000000000;3B0000000000;3B0000000000;3B0000000000;3B0000000000;3B0000000000;3B0000000000;3B0000000000;3D0000000000;100000000000003;100000000000002;100000000000004;0;380000000000;D0000000000;1000C000000000A;E0000000000;390000000000;0;100000000000003;100000000000002;100000000000004;0;0;0;0;0;0;20000000000000B;0;0;0;100000000000000;D0000000000;100000000000001;
100000000000001;1003B0000000002;1003B0000000002;1003B0000000006;3B0000000000;1003B0000000015;3B0000000000;3B0000000000;2043B0000000004;3B0000000000;3B0000000000;1003D0000000003;100000000000001;100000000000001;100000000000001;0;380000000000;D0000000000;2000C000000000B;E0000000000;380000000000;0;100000000000001;100000000000001;100000000000001;100000000000004;0;0;0;0;0;0;0;0;0;10000000000000C;D0000000000;100000000000001;
100000000000001;100000000000001;150000000000;150000000000;150000000000;150000000000;150000000000;150000000000;150000000000;150000000000;100150000000005;100000000000001;100000000000001;100000000000001;100000000000001;0;20038000000000C;D0000000000;C0000000000;E0000000000;380000000000;0;100000000000001;100000000000001;100000000000001;100000000000001;100000000000006;0;290000000000;100290000000015;290000000000;290000000000;290000000000;100290000000015;0;100000000000001;2000D0000000002;100000000000001;
100000000000001;C0000000000;C0000000000;C0000000000;C0000000000;1000C0000000015;C0000000000;C0000000000;1000C0000000015;C0000000000;C0000000000;C0000000000;C0000000000;100000000000001;100000000000001;0;380000000000;D0000000000;C0000000000;E0000000000;380000000000;0;100000000000001;100000000000001;150000000000;150000000000;150000000000;0;200280000000001;200280000000001;200280000000001;200280000000001;200280000000001;200280000000001;0;100000000000001;D0000000000;100000000000001;
100000000000001;C0000000000;2000C0000000009;200190000000009;2001A0000000009;2000C0000000009;2000C0000000009;2000C0000000009;2000C0000000009;200190000000009;2001A0000000009;2000C0000000009;C0000000000;100000000000001;100000000000001;0;3A0000000000;D0000000000;C0000000000;E0000000000;20038000000000C;0;100000000000001;100000000000001;C0000000000;210000000000;220000000000;0;100290000000015;100290000000015;100290000000015;100290000000015;100290000000015;100290000000015;0;100000000000001;1000D000000001C;100000000000001;
100000000000001;C0000000000;C0000000000;1B0000000000;1C0000000000;2050C0000000004;C0000000000;1000C0000000015;C0000000000;1B0000000000;1C0000000000;C0000000000;C0000000000;100000000000001;100000000000001;50000000000;100000000000000;D0000000000;3000C0000000001;E0000000000;3A0000000000;10000000000;100000000000001;100000000000001;2000C0000000006;230000000000;205240000000004;B0000000000;200280000000001;200280000000001;200280000000001;200280000000001;200280000000001;200280000000001;A0000000000;100000000000001;1000D0000000002;100000000000001;
100000000000001;100000000000002;100000000000002;100000000000002;100000000000002;100000000000002;100000000000002;100000000000002;100000000000002;100000000000002;100000000000002;100000000000002;100000000000002;100000000000001;100000000000001;100000000000002;100000000000002;100000000000002;1000C0000000002;1000E0000000002;100000000000002;100000000000002;100000000000001;100000000000001;100000000000001;100000000000001;100000000000001;100000000000001;100000000000001;100000000000001;100000000000001;100000000000001;100000000000001;100000000000001;100000000000001;100000000000001;100000000000001;100000000000001;
