100000000000001;100000000000001;100000000000001;100000000000001;100000000000001;100000000000001;100000000000001;100000000000001;100000000000001;100000000000001;100000000000001;100000000000001;100000000000001;100000000000001;100000000000001;100000000000001;100000000000001;100000000000001;100000000000001;100000000000001;100000000000001;100000000000001;100000000000001;100000000000001;100000000000001;100000000000001;100000000000001;100000000000001;100000000000001;
100000000000001;140000000000;0;0;0;0;0;10000000000000E;10000000000000E;10000000000000E;10000000000000E;2C0000000000;0;0;0;0;0;2D0000000000;100000000000001;100000000000001;100000000000001;100000000000001;0;0;1003C0000000009;3E0000000000;3E0000000000;100000000000001;100000000000001;
100000000000001;E0000000000;0;0;0;0;200000000000002;10000000000000E;10000000000000E;10000000000000E;10000000000000E;2C0000000000;0;0;0;0;0;2D0000000000;100000000000001;100000000000001;100000000000001;100000000000001;0;0;1053C0000000017;3B0000000000;3B0000000000;100000000000001;100000000000001;
100000000000001;E0000000000;20000000000000D;0;200000000000006;0;200000000000004;100000000000003;100000000000004;10000000000000E;10000000000000E;2C0000000000;200000000000002;0;300000000000001;0;200000000000009;2D0000000000;100000000000001;100000000000001;100000000000001;100000000000001;0;0;1003C000000000C;3B0000000000;3053B0000000002;100000000000001;100000000000001;
100000000000001;E0000000000;0;0;100000000000015;100000000000015;100000000000015;100000000000001;100000000000001;10000000000000E;10000000000000C;2C0000000000;0;100000000000005;100000000000002;100000000000006;200000000000009;2D0000000000;100000000000001;100000000000001;100000000000001;100000000000001;0;105000000000015;100000000000001;100000000000002;100000000000002;100000000000001;100000000000001;
100000000000001;E0000000000;10000000000000C;0;0;0;0;100000000000001;100000000000001;10000000000000E;100000000000001;2C0000000000;0;0;0;0;200000000000009;2D0000000000;100000000000001;100000000000001;100000000000001;100000000000001;0;0;100000000000007;100000000000001;100000000000001;100000000000001;100000000000001;
100000000000001;E0000000000;100000000000001;0;0;0;0;100000000000001;100000000000001;10000000000000E;100000000000001;2002C0000000003;200000000000003;200000000000003;0;200000000000003;200000000000003;2002D0000000003;100000000000001;100000000000001;100000000000001;100000000000001;105000000000015;105000000000000;0;3C0000000000;3E0000000000;3B0000000000;100000000000001;
100000000000001;E0000000000;100000000000009;0;204000000000004;0;0;100000000000001;100000000000001;10000000000000E;100000000000001;2C0000000000;10000000000;0;0;0;0;2D0000000000;100000000000001;100000000000001;100000000000001;100000000000008;0;390000000000;0;3C0000000000;3B0000000000;3B0000000000;100000000000001;
100000000000001;E0000000000;0;0;0;200000000000000;0;100000000000001;100000000000001;200000000000002;100000000000001;100000000000002;100000000000002;100000000000004;0;100000000000003;100000000000002;100000000000002;100000000000001;100000000000001;100000000000001;10000000000000E;0;380000000000;0;3C0000000000;3B0000000000;3B0000000000;100000000000001;
100000000000001;1000E0000000002;100000000000002;100000000000006;100000000000000;200000000000000;100000000000015;100000000000001;100000000000001;200000000000002;100000000000001;100000000000001;100000000000001;100000000000001;0;100000000000001;100000000000001;100000000000001;100000000000001;100000000000008;10000000000000E;10000000000000E;0;20538000000000C;0;3C0000000000;3B0000000000;3B0000000000;100000000000001;
100000000000001;1000E0000000001;100000000000008;0;0;200000000000000;0;100000000000001;100000000000001;200000000000002;100000000000001;100000000000001;100000000000001;100000000000001;0;100000000000001;100000000000001;2C0000000000;290000000000;0;10000000000000E;10000000000000E;0;3A0000000000;0;3C0000000000;3B0000000000;3B0000000000;100000000000001;
100000000000001;140000000000;0;0;0;200000000000000;100000000000015;100000000000001;100000000000001;10000000000000E;100000000000001;100000000000001;100000000000001;100000000000001;0;100000000000001;100000000000001;2C0000000000;205280000000001;205000000000004;10000000000000E;10000000000000E;100000000000000;105000000000000;0;3C0000000000;3B0000000000;3B0000000000;100000000000001;
100000000000001;E0000000000;0;200000000000000;0;0;0;100000000000001;100000000000001;10000000000000E;100000000000001;100000000000001;100000000000001;100000000000008;0;100000000000007;100000000000001;100000000000002;100000000000002;100000000000002;100000000000002;100000000000006;0;10000000000000A;0;1003C000000000A;3B0000000000;3B0000000000;100000000000001;
100000000000001;2000E0000000005;0;100000000000015;0;100000000000015;100000000000015;100000000000007;100000000000008;10000000000000E;100000000000001;100000000000001;100000000000001;0;0;0;100000000000001;100000000000001;100000000000001;0;0;0;0;0;0;3C0000000000;3B0000000000;3B0000000000;100000000000001;
100000000000001;1000E0000000015;0;0;0;0;0;20000000000000B;0;0;100000000000007;100000000000001;0;0;0;0;0;100000000000001;100000000000001;0;0;0;290000000000;0;290000000000;3C0000000000;1003B0000000015;3B0000000000;100000000000001;
100000000000001;2000E0000000003;0;100000000000015;0;0;0;0;0;0;0;100000000000001;0;203000000000009;0;0;0;100000000000001;100000000000001;0;10000000000000E;0;205280000000001;206000000000004;205280000000001;3C0000000000;1003B000000000E;3B0000000000;100000000000001;
100000000000001;100140000000015;0;0;0;200000000000000;0;0;0;0;0;100000000000001;0;203000000000009;10000000000000A;0;0;100000000000001;100000000000001;0;100000000000015;100000000000015;100000000000015;100290000000015;100000000000015;1003C0000000015;1003B0000000015;3B0000000000;100000000000001;
100000000000001;E0000000000;0;100000000000015;0;200100000000000;120000000000;120000000000;120000000000;F0000000000;0;100000000000001;0;203000000000009;0;203000000000002;0;100000000000001;100000000000001;0;0;0;0;205280000000001;0;3C0000000000;3B0000000000;3B0000000000;100000000000001;
100000000000001;E0000000000;204000000000004;0;0;100170000000015;190000000000;1A0000000000;C0000000000;E0000000000;0;100000000000001;0;203000000000009;0;0;0;100000000000001;100000000000001;0;0;0;100000000000015;100000000000015;100000000000015;3C0000000000;290000000000;3B0000000000;100000000000001;
100000000000001;E0000000000;0;0;0;D0000000000;2000C0000000009;2000C0000000009;2000C0000000009;2000E0000000009;0;100000000000001;0;0;0;0;0;100000000000001;100000000000001;203000000000004;0;0;204000000000005;0;103000000000000;2033C0000000004;205280000000001;3B0000000000;100000000000001;
100000000000001;E0000000000;0;0;0;D0000000000;100150000000015;100150000000015;100150000000015;100140000000015;0;100000000000001;0;0;10000000000;0;0;100000000000001;100000000000001;100000000000015;100000000000015;100000000000015;290000000000;0;290000000000;1003C0000000015;1003B0000000015;1003B0000000015;100000000000001;
100000000000001;E0000000000;105000000000000;100000000000000;0;2030D0000000004;2000C0000000009;2000C0000000009;2000C0000000009;2000E0000000009;0;100000000000001;0;100000000000003;100000000000002;100000000000004;0;100000000000001;100000000000001;0;103000000000000;0;205280000000001;203000000000004;205280000000001;3C0000000000;1033B0000000000;3B0000000000;100000000000001;
100000000000001;E0000000000;390000000000;0;100000000000003;100000000000002;100000000000002;100000000000002;100000000000002;100000000000002;100000000000001;100000000000001;0;100000000000001;100000000000001;100000000000001;0;100000000000001;100000000000001;0;0;100000000000015;100000000000015;100290000000015;100000000000015;1003C0000000015;3B0000000000;3B0000000000;100000000000001;
100000000000001;E0000000000;380000000000;0;100000000000001;100000000000001;0;0;0;0;100000000000001;100000000000001;0;100000000000001;100000000000001;100000000000001;0;100000000000001;100000000000001;0;103000000000000;0;0;205280000000001;205000000000004;3C0000000000;1033B0000000000;2043B0000000004;100000000000001;
100000000000001;E0000000000;380000000000;0;100000000000001;100000000000001;100000000000;120000000000;120000000000;F0000000000;100000000000001;100000000000008;0;100000000000007;100000000000001;100000000000008;0;100000000000007;100000000000001;0;0;100000000000015;100290000000015;100000000000015;100290000000015;1003C0000000015;3B0000000000;3B0000000000;100000000000001;
100000000000001;E0000000000;20538000000000C;0;100000000000001;100000000000001;D0000000000;2050C0000000003;2050C0000000003;E0000000000;100000000000001;0;0;0;100000000000001;0;0;0;100000000000001;204000000000004;103000000000000;0;205280000000001;203000000000004;205280000000001;3C0000000000;1033B0000000000;3B0000000000;100000000000001;
100000000000001;E0000000000;380000000000;0;100000000000007;100000000000001;D0000000000;2050C0000000003;2050C0000000003;E0000000000;100000000000001;0;0;100000000000;100000000000001;F0000000000;0;0;100000000000001;0;0;100290000000015;100000000000015;100290000000015;100000000000015;100290000000015;3B0000000000;3B0000000000;100000000000001;
100000000000001;E0000000000;380000000000;0;0;100000000000001;D0000000000;2050C0000000003;2050C0000000003;E0000000000;100000000000001;0;0;D0000000000;100000000000001;E0000000000;0;0;100000000000001;0;105000000000000;200280000000001;205000000000004;200280000000001;0;200280000000001;1053B0000000000;3B0000000000;100000000000001;
100000000000001;290000000000;3A0000000000;0;0;100000000000009;D0000000000;100150000000015;100150000000015;E0000000000;100000000000009;0;0;D0000000000;100000000000001;E0000000000;0;0;100000000000009;0;0;100000000000015;100000000000015;100000000000015;100000000000015;1003C0000000015;3B0000000000;3B0000000000;100000000000001;
100000000000001;200280000000001;100000000000000;0;0;0;D0000000000;C0000000000;2050C0000000004;E0000000000;0;105000000000000;0;D0000000000;100000000000001;E0000000000;0;0;0;100000000000000;0;0;0;0;10000000000;3C0000000000;3B0000000000;1003B0000000000;100000000000001;
100000000000001;100280000000002;100000000000004;10000000000000E;10000000000000E;100000000000005;100000000000002;100000000000002;100000000000002;100000000000002;100000000000002;100000000000004;20000000000000A;100000000000003;100000000000001;100000000000004;20000000000000A;100000000000003;100000000000002;100000000000002;100000000000004;100000000000015;0;100000000000003;100000000000002;100000000000002;100000000000002;100000000000002;100000000000001;
100000000000001;100000000000001;100000000000001;100000000000015;10000000000000E;10000000000000E;100000000000001;100000000000001;100000000000001;100000000000001;100000000000001;100000000000001;100000000000002;100000000000001;100000000000001;100000000000001;100000000000002;100000000000001;100000000000001;100000000000001;100000000000001;0;0;100000000000001;100000000000001;100000000000001;100000000000001;100000000000001;100000000000001;
100000000000001;100000000000001;100000000000001;10000000000000E;10000000000000E;10000000000000E;100000000000001;100000000000001;100000000000001;100000000000001;100000000000001;100000000000001;100000000000001;100000000000001;100000000000001;100000000000001;100000000000001;100000000000001;100000000000001;100000000000001;100000000000001;0;100000000000015;100000000000001;100000000000001;100000000000001;100000000000001;100000000000001;100000000000001;
100000000000001;100000000000001;100000000000001;10000000000000E;100000000000015;10000000000000E;100000000000007;100000000000001;100000000000001;100000000000001;100000000000001;100000000000001;100000000000001;100000000000001;100000000000001;100000000000001;100000000000001;100000000000001;100000000000001;100000000000001;100000000000008;0;0;100000000000007;100000000000001;100000000000001;100000000000001;100000000000001;100000000000001;
100000000000001;100000000000001;100000000000008;204000000000003;204000000000003;204000000000003;0;0;3C0000000000;3E0000000000;3B0000000000;3E0000000000;3B0000000000;3E0000000000;3B0000000000;3E0000000000;3B0000000000;3E0000000000;3B0000000000;0;0;100000000000015;0;0;0;0;3E0000000000;3E0000000000;100000000000001;
100000000000001;100000000000001;2C0000000000;0;0;100000000000015;0;0;3C0000000000;3B0000000000;3B0000000000;3B0000000000;3B0000000000;3B0000000000;3B0000000000;3B0000000000;3B0000000000;3B0000000000;3B0000000000;0;0;0;0;0;0;0;3B0000000000;3B0000000000;100000000000001;
100000000000001;100000000000001;2C0000000000;100000000000015;0;0;0;290000000000;2063C0000000000;2063B0000000000;2063B0000000000;2063B0000000000;2063B0000000000;3B0000000000;2063B0000000000;2063B0000000000;2063B0000000000;2063B0000000000;2063B0000000000;290000000000;0;0;100000000000015;0;0;290000000000;3B0000000000;3B0000000000;100000000000001;
100000000000001;100000000000001;2C0000000000;0;20400000000000D;0;0;204280000000001;3C0000000000;3B0000000000;3B0000000000;3B0000000000;3B0000000000;2063B0000000004;3B0000000000;3B0000000000;3B0000000000;3B0000000000;3B0000000000;204280000000001;0;0;214000000000012;0;0;200280000000001;3B0000000000;3B0000000000;100000000000001;
100000000000001;100000000000001;100000000000001;100000000000001;100000000000001;100000000000001;100000000000001;100000000000001;100000000000001;100000000000001;100000000000001;100000000000001;100000000000001;100000000000001;100000000000001;100000000000001;100000000000001;100000000000001;100000000000001;100000000000001;100000000000001;100000000000001;100000000000001;100000000000001;100000000000001;100000000000001;100000000000001;100000000000001;100000000000001;
