0;100000000000001;100000000000001;100000000000001;100000000000001;100000000000001;100000000000001;100000000000001;100000000000001;100000000000001;100000000000001;100000000000001;100000000000001;100000000000001;100000000000001;100000000000001;100000000000001;100000000000001;100000000000001;100000000000001;100000000000001;100000000000001;100000000000001;100000000000001;100000000000001;100000000000001;100000000000001;100000000000001;100000000000001;100000000000001;100000000000001;100000000000001;100000000000001;100000000000001;100000000000001;100000000000001;100000000000001;100000000000001;100000000000001;100000000000001;100000000000001;100000000000001;100000000000001;100000000000001;100000000000001;100000000000001;100000000000001;100000000000001;100000000000001;100000000000001;100000000000001;100000000000001;100000000000001;100000000000001;100000000000001;100000000000001;100000000000001;100000000000001;100000000000001;100000000000001;100000000000001;100000000000001;100000000000001;100000000000001;100000000000001;100000000000001;100000000000001;100000000000001;100000000000001;100000000000001;100000000000001;100000000000001;100000000000001;100000000000001;100000000000001;100000000000001;100000000000001;
100000000000001;0;0;0;0;0;0;0;0;0;0;0;0;0;0;0;0;0;20400000000000B;0;0;0;0;0;0;0;0;0;0;0;0;0;0;0;0;0;0;200000000000009;200000000000009;0;0;0;0;0;0;0;0;200000000000000;0;0;0;0;0;20500000000000B;0;0;0;0;0;200000000000000;0;10000000000000E;0;0;0;0;0;0;0;0;0;0;0;0;0;0;100000000000001;
100000000000001;0;0;0;200000000000003;300000000000001;20000000000000D;0;204000000000000;204000000000000;0;0;204000000000000;204000000000000;204000000000003;0;0;0;0;0;0;0;0;0;0;0;0;0;0;200000000000000;200000000000000;0;0;0;0;0;0;200000000000009;200000000000009;0;0;200000000000000;0;0;0;200000000000000;0;0;0;0;0;0;0;0;0;0;0;0;200000000000000;0;200000000000000;10000000000000E;0;0;200000000000003;200000000000003;200000000000009;200000000000009;200000000000009;200000000000009;200000000000009;200000000000009;200000000000009;200000000000009;0;200000000000002;100000000000001;
100000000000001;0;0;0;200000000000003;10000000000000C;0;100000000000015;204000000000000;204000000000000;204000000000004;0;104000000000015;106000000000015;10000000000000C;0;0;0;0;0;0;0;0;0;0;0;0;0;0;200000000000000;200000000000000;0;200000000000003;0;200000000000003;0;0;100000000000015;100000000000015;0;0;10000000000000C;0;0;100000000000003;100000000000004;0;100000000000015;0;0;290000000000;0;290000000000;0;290000000000;0;290000000000;0;105000000000015;105000000000015;100000000000015;10000000000000E;0;0;100000000000015;100000000000015;100000000000015;100000000000015;100000000000015;100000000000015;100000000000015;100000000000015;100000000000015;100000000000015;100000000000015;100000000000015;100000000000001;
100000000000001;0;0;0;100000000000003;100000000000001;0;0;0;0;0;0;204000000000000;100000000000003;100000000000001;0;0;0;0;0;0;20500000000000E;100000000000003;100000000000002;100000000000002;100000000000002;100000000000004;0;0;100000000000015;100000000000015;0;100000000000015;0;100000000000015;0;0;0;0;0;100000000000003;100000000000001;100000000000015;0;100000000000001;100000000000008;0;0;10000000000000E;205000000000004;200280000000001;205000000000004;200280000000001;205000000000004;200280000000001;205000000000004;200280000000001;205000000000004;10000000000000E;0;0;10000000000000E;0;100000000000015;0;0;0;0;0;201000000000004;0;0;0;0;0;0;100000000000001;
100000000000001;0;0;100000000000003;100000000000001;100000000000001;0;0;100290000000015;100000000000015;0;0;100000000000003;100000000000001;100000000000001;100000000000015;0;290000000000;0;0;0;100000000000003;100000000000001;205000000000009;205000000000009;205000000000009;100000000000001;100000000000004;0;0;0;0;0;0;0;0;0;0;0;100000000000003;100000000000001;100000000000001;0;100000000000003;100000000000008;0;0;0;100000000000015;100000000000015;100000000000015;100000000000015;100000000000015;100000000000015;100000000000015;100000000000015;100000000000015;100000000000015;100000000000015;0;200000000000000;10000000000000E;0;0;0;0;201000000000004;0;0;0;0;0;0;0;0;0;100000000000001;
100000000000001;0;0;100000000000001;100000000000001;100000000000001;0;206000000000004;200280000000001;0;106000000000000;0;100000000000001;100000000000001;100000000000001;0;205000000000004;205280000000001;0;105000000000000;106000000000015;100000000000007;100000000000008;205000000000009;205000000000009;205000000000009;100000000000001;100000000000001;100000000000015;0;0;0;0;20000000000000A;0;0;0;0;100000000000015;100000000000001;100000000000001;100000000000001;10000000000001C;100000000000001;0;0;105000000000015;100000000000000;0;0;290000000000;0;0;0;0;0;0;0;0;0;100000000000015;10000000000000E;0;0;0;0;0;0;290000000000;0;0;0;0;0;0;0;100000000000001;
100000000000001;0;100000000000005;100000000000001;100000000000001;100000000000001;100000000000002;100000000000002;100000000000002;100000000000006;0;0;100000000000001;100000000000001;100000000000001;100000000000002;100000000000002;100000000000002;100000000000004;0;0;10500000000000E;10500000000000E;0;105000000000015;0;100000000000001;100000000000001;0;0;10000000000000C;10000000000001C;100000000000003;100000000000002;100000000000002;100000000000004;0;0;0;100000000000001;100000000000001;100000000000001;100000000000001;100000000000001;100000000000004;0;0;390000000000;0;0;205280000000001;0;0;105000000000000;0;206000000000004;105000000000000;0;10000000000000E;0;0;10000000000000E;0;200000000000000;0;0;0;0;201280000000001;0;0;0;0;0;0;0;100000000000001;
100000000000001;0;0;100000000000001;100000000000001;100000000000001;0;0;0;0;106000000000015;0;100000000000001;100000000000001;100000000000001;0;0;100000000000001;100000000000001;0;0;10500000000000E;10500000000000E;205000000000004;205000000000004;100000000000003;100000000000001;100000000000001;0;100000000000015;100000000000001;100000000000002;100000000000001;0;0;100000000000001;100000000000004;0;0;100000000000001;100000000000001;100000000000001;0;0;100000000000001;100000000000004;0;380000000000;0;0;10000000000000C;10000000000001A;0;0;100000000000003;100000000000004;0;0;10000000000000E;100000000000003;100000000000002;100000000000002;100000000000002;100000000000004;0;0;0;200000000000000;100000000000003;1002B0000000004;2B0000000000;2B0000000000;1002B000000000C;10500000000001A;0;0;100000000000001;
100000000000001;200000000000002;0;100000000000001;100000000000001;100000000000001;206000000000003;0;290000000000;0;0;0;100000000000001;100000000000001;100000000000001;0;0;100000000000001;100000000000001;106000000000015;0;100000000000003;100000000000002;100000000000002;100000000000002;100000000000001;100000000000001;100000000000001;205000000000005;0;100000000000001;100000000000001;100000000000001;290000000000;0;100000000000001;100000000000001;0;0;100000000000001;100000000000001;100000000000001;0;0;100000000000001;100000000000001;0;200380000000000;0;100000000000003;100000000000001;100000000000004;0;0;100000000000001;100000000000001;0;0;100000000000003;100000000000001;100000000000001;0;0;100000000000001;100000000000004;0;0;100000000000003;100000000000001;1002B0000000001;1052B0000000015;2B0000000000;1002B0000000001;100000000000004;0;0;100000000000001;
100000000000001;200000000000002;0;100000000000001;100000000000001;100000000000001;100000000000000;202000000000004;206280000000001;0;102000000000000;106000000000015;100000000000001;100000000000001;100000000000001;0;0;100000000000001;100000000000001;200000000000000;0;100000000000001;100000000000001;0;0;0;100000000000001;100000000000001;100000000000015;0;100000000000001;100000000000001;100000000000001;200280000000001;0;100000000000001;100000000000001;100000000000015;0;100000000000001;100000000000001;100000000000001;0;0;100000000000001;100000000000001;0;20638000000000C;0;100000000000001;100000000000001;100000000000001;0;0;100000000000001;100000000000001;100000000000015;0;100000000000001;100000000000001;100000000000001;0;0;100000000000001;100000000000001;0;105000000000015;100000000000001;100000000000001;1002B0000000001;2B0000000000;2002B0000000009;1002B0000000001;100000000000001;0;0;100000000000001;
100000000000001;0;0;100000000000001;100000000000001;100000000000001;10600000000001C;100000000000003;100000000000002;0;390000000000;0;100000000000001;100000000000001;100000000000008;0;0;100000000000001;100000000000001;100000000000015;0;100000000000001;100000000000001;0;0;0;100000000000001;100000000000001;0;0;100000000000001;100000000000001;100000000000001;100000000000015;0;100000000000001;100000000000001;0;0;100000000000001;100000000000001;100000000000001;0;0;100000000000001;100000000000001;0;200380000000000;0;100000000000001;100000000000001;100000000000001;0;0;100000000000001;100000000000001;0;0;100000000000001;100000000000001;100000000000001;0;0;100000000000001;100000000000001;0;0;100000000000001;100000000000001;1002B0000000001;2002B0000000009;1052B0000000015;1002B0000000001;100000000000001;0;0;100000000000001;
100000000000001;0;0;100000000000001;100000000000001;100000000000001;100000000000001;100000000000008;0;0;380000000000;0;100000000000001;100000000000001;0;0;0;100000000000001;100000000000008;200000000000000;0;100000000000007;100000000000001;0;100000000000003;100000000000002;100000000000001;100000000000001;0;100390000000015;100000000000001;100000000000001;100000000000001;0;0;100000000000001;100000000000001;0;100000000000015;100000000000001;100000000000001;100000000000001;0;0;100000000000001;100000000000001;0;200380000000000;0;100000000000007;100000000000001;100000000000001;10600000000001C;10600000000001C;100000000000001;100000000000001;0;100000000000015;100000000000007;100000000000001;100000000000001;0;0;100000000000001;100000000000008;105000000000015;0;100000000000007;100000000000001;1002B0000000001;2012B0000000006;2052B0000000004;1002B0000000001;100000000000008;0;0;100000000000001;
100000000000001;0;0;100000000000007;100000000000001;100000000000001;100000000000008;0;0;0;380000000000;0;100000000000009;0;0;0;204000000000004;100000000000009;0;106000000000015;0;0;100000000000007;100000000000002;100000000000008;0;100000000000007;100000000000008;0;380000000000;100000000000007;100000000000001;100000000000008;100000000000015;100000000000000;100000000000007;100000000000008;0;0;100000000000007;100000000000001;100000000000008;0;0;100000000000007;100000000000008;0;200380000000000;0;3E0000000000;1003B0000000007;100000000000001;100000000000002;100000000000002;100000000000001;100000000000001;200000000000000;0;0;100000000000007;100000000000001;100000000000002;100000000000002;100000000000008;0;0;200000000000000;0;100000000000007;100000000000001;100000000000002;100000000000002;100000000000008;0;0;0;100000000000001;
100000000000001;0;0;0;0;0;0;0;0;0;20038000000000C;0;0;0;0;0;0;0;0;0;0;0;0;20000000000000B;0;0;0;0;0;380000000000;0;0;0;0;390000000000;0;0;100000000000015;0;0;0;0;0;0;0;0;0;200380000000000;0;3B0000000000;1062B0000000017;2B0000000000;2B0000000000;2B0000000000;1002B0000000001;100000000000001;100000000000015;0;0;20500000000000B;0;0;0;0;201000000000004;0;105000000000015;0;0;0;0;20000000000000B;0;0;0;0;100000000000001;
100000000000001;0;0;0;0;0;0;0;0;0;380000000000;0;0;0;0;0;0;0;0;0;100000000000015;0;0;0;0;0;0;0;0;20038000000000C;0;0;0;0;380000000000;0;0;0;0;0;0;0;0;0;0;0;0;3A0000000000;0;100000000000003;100000000000002;1002B0000000004;2B0000000000;2B0000000000;1002B0000000001;100000000000001;0;0;204000000000004;0;0;0;0;0;200000000000003;200000000000003;200000000000000;0;0;0;0;0;0;0;0;0;100000000000001;
100000000000001;0;0;0;0;0;290000000000;0;0;0;3A0000000000;0;0;0;0;0;100000000000000;0;0;0;0;0;0;0;290000000000;0;0;0;0;3A0000000000;0;0;0;0;2003A000000000C;0;0;100000000000015;100000000000015;0;0;0;290000000000;0;0;0;0;106000000000000;0;100000000000007;100000000000001;1002B0000000001;2062B0000000001;2062B0000000007;1002B0000000001;100000000000008;100000000000015;0;0;0;0;0;105000000000015;105000000000015;105000000000015;105000000000015;105000000000015;105000000000015;0;0;0;0;0;0;0;0;100000000000001;
100000000000001;0;0;10000000000000E;0;215000000000012;200280000000001;0;205000000000004;0;100000000000000;100000000000000;0;0;206000000000004;21A000000000012;0;0;100000000000000;100000000000015;0;10500000000000E;0;205000000000004;200280000000001;205000000000004;21B000000000012;10500000000000E;0;100000000000000;0;205000000000004;0;20500000000000A;100000000000000;0;0;100000000000000;0;10000000000000E;206000000000004;206000000000004;200280000000001;206000000000004;10000000000000E;0;100000000000015;100000000000015;0;0;100000000000007;1002B0000000001;1002B0000000002;100000000000002;100000000000008;0;0;200000000000000;0;0;0;0;0;0;0;0;0;0;0;0;0;200000000000005;0;0;0;0;100000000000001;
100000000000001;0;0;100000000000003;100000000000002;100000000000002;100000000000002;100000000000002;100000000000002;100000000000006;0;0;100000000000003;100000000000002;100000000000002;100000000000002;100000000000002;100000000000004;0;0;0;100000000000003;100000000000002;100000000000002;100000000000002;100000000000002;100000000000002;100000000000006;0;0;100000000000003;100000000000002;100000000000002;100000000000002;100000000000002;100000000000002;100000000000006;0;0;100000000000003;100000000000002;100000000000002;100000000000002;100000000000002;100000000000004;20600000000000F;0;0;0;0;0;200000000000003;200000000000003;200000000000003;0;0;0;100000000000015;0;100000000000003;100000000000002;100000000000002;100000000000002;100000000000002;0;0;10000000000000C;10500000000001A;0;0;100000000000003;100000000000002;100000000000004;0;0;0;100000000000001;
100000000000001;0;0;100000000000001;100000000000001;100000000000001;0;0;0;0;0;0;100000000000001;100000000000001;100000000000001;0;0;100000000000001;100000000000006;0;0;100000000000001;100000000000001;100000000000001;0;0;0;0;0;0;100000000000001;100000000000001;100000000000001;0;0;0;0;0;100000000000015;100000000000001;100000000000001;100000000000001;0;0;100000000000001;100000000000004;0;0;0;0;100000000000003;100000000000002;100000000000002;100000000000002;100000000000004;0;0;0;100000000000003;100000000000001;2002B0000000000;200290000000000;2002B0000000000;100000000000007;100000000000004;0;100000000000001;100000000000004;0;100000000000003;1003B0000000001;3E0000000000;1003B0000000007;100000000000004;0;0;100000000000001;
100000000000001;0;0;100000000000001;100000000000001;100000000000001;205000000000005;200000000000009;0;0;0;100000000000015;100000000000001;100000000000001;100000000000001;0;100000000000003;100000000000008;0;0;100000000000015;100000000000001;100000000000001;100000000000001;205000000000002;0;0;0;100000000000015;20500000000000E;100000000000001;100000000000001;100000000000001;205000000000003;205000000000003;205000000000003;0;0;0;100000000000001;100000000000001;100000000000001;0;0;100000000000001;100000000000001;0;101390000000015;0;100000000000003;100000000000001;100000000000001;0;0;100000000000001;100000000000004;0;0;1003B0000000007;100000000000001;2002B0000000000;200280000000001;2002B000000000D;1003B0000000019;3E0000000000;0;100000000000001;100000000000001;0;100000000000001;1003B0000000001;3B0000000000;3E0000000000;1003B0000000009;100000000000015;0;100000000000001;
100000000000001;0;0;100000000000001;100000000000001;100000000000001;20000000000000D;200000000000009;0;0;0;0;100000000000001;100000000000001;100000000000001;100000000000002;100000000000001;20000000000000F;0;0;0;100000000000001;100000000000001;100000000000001;0;0;0;0;0;0;100000000000001;100000000000001;100000000000001;205000000000003;205000000000003;205000000000003;0;100000000000015;0;100000000000001;100000000000001;100000000000001;0;0;100000000000001;100000000000008;0;200380000000000;0;100000000000001;100000000000001;100000000000001;0;0;100000000000001;100000000000001;0;0;3E0000000000;100000000000001;1002B0000000002;100000000000002;100000000000002;1003B0000000004;3B0000000000;105000000000015;100000000000001;100000000000001;0;100000000000001;1003B0000000001;3B0000000000;3B0000000000;3E0000000000;0;0;100000000000001;
100000000000001;0;20000000000000D;100000000000001;100000000000001;100000000000001;100000000000002;100000000000006;0;0;100000000000015;100000000000015;100000000000001;100000000000001;100000000000001;100000000000001;100000000000001;100000000000004;0;100000000000015;0;100000000000001;100000000000001;100000000000001;100000000000002;100000000000006;0;100000000000015;0;0;100000000000001;100000000000001;100000000000001;100000000000002;100000000000006;205000000000000;105000000000015;0;0;100000000000001;100000000000001;100000000000001;100000000000002;100000000000002;100000000000001;0;0;200380000000000;0;100000000000001;100000000000001;100000000000001;100000000000002;100000000000002;100000000000001;100000000000001;100000000000015;0;3B0000000000;1002B0000000009;2B0000000000;2B0000000000;2B0000000000;1003B0000000001;3B0000000000;0;100000000000001;100000000000001;0;100000000000001;1003B0000000001;3003B0000000002;3B0000000000;3B0000000000;0;100000000000015;100000000000001;
100000000000001;0;0;100000000000001;100000000000001;100000000000001;0;0;0;0;0;0;100000000000001;100000000000001;100000000000001;0;0;100000000000001;100000000000004;0;0;100000000000001;100000000000001;100000000000001;205000000000000;205000000000000;205000000000000;205000000000000;0;0;100000000000001;100000000000001;100000000000001;200000000000000;200000000000000;205000000000000;0;0;0;100000000000001;100000000000001;100000000000001;0;0;100000000000001;100000000000004;0;200380000000000;0;100000000000001;100000000000001;100000000000001;0;0;100000000000001;100000000000001;0;0;3B0000000000;1002B0000000018;2B0000000000;2002B0000000000;2B0000000000;100000000000001;100000000000004;0;100000000000001;100000000000001;0;100000000000001;1003B0000000001;1002B0000000015;1002B0000000015;2B0000000000;0;0;100000000000001;
100000000000001;0;0;100000000000001;100000000000001;100000000000001;0;0;100000000000015;100000000000015;100000000000000;0;100000000000001;100000000000001;100000000000001;0;0;100000000000001;100000000000001;0;100000000000015;100000000000001;100000000000001;100000000000001;205000000000000;205000000000000;205000000000000;205000000000000;100000000000015;0;100000000000001;100000000000001;100000000000001;200000000000000;200000000000000;205000000000000;105000000000015;0;0;100000000000001;100000000000001;100000000000001;0;0;100000000000001;100000000000001;0;200380000000000;0;100000000000001;100000000000001;100000000000001;0;0;100000000000001;100000000000001;0;100000000000015;100000000000003;100000000000004;2B0000000000;100290000000015;2B0000000000;100000000000001;100000000000001;0;100000000000001;100000000000001;0;100000000000001;1003B0000000001;2B0000000000;2B0000000000;10000000000000C;0;100000000000015;100000000000001;
100000000000001;0;0;100000000000001;100000000000001;100000000000001;20000000000000F;0;0;0;20039000000000C;0;100000000000001;100000000000001;100000000000001;0;0;100000000000001;100000000000001;0;0;100000000000001;100000000000001;100000000000001;200000000000009;200000000000009;200000000000009;200000000000009;0;0;100000000000001;100000000000001;100000000000001;200000000000009;200000000000009;205000000000000;205000000000000;0;0;100000000000001;100000000000001;100000000000001;0;0;100000000000001;100000000000008;0;200380000000000;0;100000000000001;100000000000001;100000000000001;0;0;100000000000001;100000000000001;0;0;100000000000007;100000000000001;2002B0000000008;200280000000001;2B0000000000;100000000000001;100000000000008;0;100000000000001;100000000000001;0;100000000000007;1003B0000000001;2B0000000000;1003B0000000003;100000000000008;0;0;100000000000001;
100000000000001;0;0;100000000000007;100000000000001;100000000000008;0;0;0;0;380000000000;0;100000000000007;100000000000001;100000000000008;0;0;100000000000007;100000000000008;100000000000015;0;100000000000007;100000000000001;100000000000001;100000000000002;100000000000002;100000000000002;100000000000006;0;0;100000000000007;100000000000001;100000000000001;100000000000002;100000000000002;100000000000002;100000000000006;100000000000015;0;100000000000007;100000000000001;100000000000001;100000000000002;100000000000002;100000000000008;0;201000000000004;200380000000000;0;100000000000007;100000000000001;100000000000008;0;0;100000000000007;100000000000008;100000000000015;0;0;100000000000007;100000000000002;100000000000002;100000000000002;100000000000008;0;0;100000000000007;100000000000008;0;0;100000000000007;1003B0000000002;100000000000008;0;100000000000015;0;100000000000001;
100000000000001;0;0;0;0;0;0;0;0;0;380000000000;0;0;0;0;0;0;0;0;0;0;0;0;0;0;0;0;0;0;105000000000015;0;0;0;0;0;0;0;0;0;0;0;0;0;0;0;0;0;20038000000000C;0;0;0;0;0;0;0;0;0;0;0;0;0;0;0;0;0;0;0;0;0;0;0;0;0;0;0;0;100000000000001;
100000000000001;0;0;290000000000;0;0;0;290000000000;0;0;3A0000000000;0;290000000000;0;0;0;0;0;290000000000;0;100000000000015;0;0;0;290000000000;0;0;0;0;0;290000000000;0;0;0;0;0;290000000000;0;100000000000015;0;290000000000;0;0;0;0;290000000000;0;3A0000000000;0;0;0;290000000000;0;0;0;0;100000000000015;290000000000;0;0;0;0;0;290000000000;0;100000000000015;0;0;290000000000;100000000000015;0;0;0;290000000000;0;100000000000015;100000000000001;
100000000000001;0;0;200280000000001;0;205000000000004;0;200280000000001;0;0;100000000000000;0;200280000000001;0;0;206000000000004;0;0;200280000000001;0;0;0;105000000000000;0;205280000000001;0;205000000000004;0;100000000000015;0;205280000000001;0;100000000000000;0;206000000000004;0;205280000000001;0;10500000000000E;0;205280000000001;0;0;203000000000004;0;200280000000001;0;100000000000000;10000000000000E;0;0;200280000000001;0;0;0;0;0;200280000000001;0;0;205000000000004;0;0;200280000000001;10000000000000E;10000000000000E;0;0;200280000000001;0;0;205000000000004;0;200280000000001;0;0;100000000000001;
100000000000001;100000000000001;100000000000001;100000000000001;100000000000001;100000000000001;100000000000001;100000000000001;100000000000001;100000000000001;100000000000001;100000000000001;100000000000001;100000000000001;100000000000001;100000000000001;100000000000001;100000000000001;100000000000001;100000000000001;100000000000001;100000000000001;100000000000001;100000000000001;100000000000001;100000000000001;100000000000001;100000000000001;100000000000001;100000000000001;100000000000001;100000000000001;100000000000001;100000000000001;100000000000001;100000000000001;100000000000001;100000000000001;100000000000001;100000000000001;100000000000001;100000000000001;100000000000001;100000000000001;100000000000001;100000000000001;100000000000001;100000000000001;100000000000001;100000000000001;100000000000001;100000000000001;100000000000001;100000000000001;100000000000001;100000000000001;100000000000001;100000000000001;100000000000001;100000000000001;100000000000001;100000000000001;100000000000001;100000000000001;100000000000001;100000000000001;100000000000001;100000000000001;100000000000001;100000000000001;100000000000001;100000000000001;100000000000001;100000000000001;100000000000001;100000000000001;100000000000001;
