100000000000001;100000000000001;100000000000001;100000000000001;100000000000001;100000000000001;100000000000001;100000000000001;100000000000001;100000000000001;100000000000001;100000000000001;100000000000001;100000000000001;100000000000001;100000000000001;100000000000001;100000000000001;100000000000001;100000000000001;100000000000001;100000000000001;100000000000001;100000000000001;100000000000001;100000000000001;100000000000001;100000000000001;100000000000001;100000000000001;100000000000001;
100000000000001;0;0;0;0;0;0;201000000000004;0;0;0;0;0;0;0;0;0;0;0;0;0;0;0;0;3C0000000000;3B0000000000;1003B0000000019;3B0000000000;3B0000000000;3003B0000000002;100000000000001;
100000000000001;0;0;0;0;0;290000000000;0;290000000000;0;0;0;0;0;290000000000;0;0;0;0;0;204000000000004;0;0;0;3C0000000000;100000000000003;100000000000002;100000000000002;100000000000002;100000000000002;100000000000001;
100000000000001;290000000000;0;100000000000015;104000000000000;0;200280000000001;205000000000004;200280000000001;0;205000000000004;104000000000000;104000000000000;0;200280000000001;207000000000004;0;0;104000000000000;0;0;104000000000000;207000000000004;0;3C0000000000;100000000000001;2073B0000000008;3D0000000000;0;0;100000000000001;
100000000000001;200280000000001;0;0;20000000000000E;100000000000003;100000000000002;100000000000002;100000000000002;100000000000002;100000000000006;0;0;100000000000003;100000000000002;100000000000002;100000000000002;100000000000004;0;0;0;0;100000000000003;100000000000002;100000000000002;100000000000001;100000000000004;2073D0000000001;0;20700000000000E;100000000000001;
100000000000001;100000000000015;100000000000015;0;0;100000000000001;100000000000001;100000000000001;0;0;20000000000000B;100000000000015;0;100000000000001;100000000000001;100000000000001;0;100000000000007;100000000000002;100000000000004;104000000000000;100000000000003;100000000000001;100000000000001;0;0;100000000000007;100000000000004;0;0;100000000000001;
100000000000001;20000000000000F;0;0;0;100000000000001;100000000000001;100000000000001;0;0;0;0;200000000000003;100000000000001;100000000000001;100000000000001;0;0;0;100000000000001;0;100000000000001;100000000000001;100000000000001;0;0;0;100000000000009;100000000000015;0;100000000000001;
100000000000001;0;290000000000;100000000000015;0;100000000000001;100000000000001;100000000000001;0;290000000000;0;0;100000000000015;100000000000001;100000000000001;100000000000001;0;0;0;100000000000001;0;100000000000001;100000000000001;100000000000001;200000000000000;0;290000000000;0;0;0;100000000000001;
100000000000001;0;200280000000001;0;0;100000000000001;100000000000001;100000000000001;207000000000004;207280000000001;107000000000000;0;0;100000000000001;100000000000001;100000000000001;0;0;100000000000003;100000000000001;0;100000000000001;100000000000001;100000000000001;0;207000000000004;201280000000001;0;107000000000000;100000000000015;100000000000001;
100000000000001;0;100390000000015;0;0;100000000000001;100000000000001;100000000000001;100000000000002;100000000000006;0;0;100000000000015;100000000000001;100000000000001;100000000000001;100000000000002;100000000000001;100000000000001;100000000000008;0;100000000000001;100000000000001;100000000000001;100000000000015;100000000000015;100000000000015;100000000000015;0;0;100000000000001;
100000000000001;0;380000000000;200000000000003;0;100000000000001;100000000000001;100000000000001;0;0;107000000000015;0;0;100000000000001;100000000000001;100000000000001;0;100000000000001;100000000000001;0;0;100000000000001;100000000000001;100000000000001;0;0;0;0;0;200000000000000;100000000000001;
100000000000001;104000000000000;380000000000;100000000000015;0;100000000000001;100000000000001;100000000000001;0;0;0;0;200000000000003;100000000000001;100000000000001;100000000000001;0;0;100000000000007;100000000000004;0;100000000000001;100000000000001;100000000000001;10100000000000E;290000000000;0;10000000000000C;0;0;100000000000001;
100000000000001;204000000000004;380000000000;200000000000003;0;100000000000001;100000000000001;100000000000001;0;20700000000000D;0;107000000000015;107000000000015;100000000000001;100000000000001;100000000000001;0;0;0;100000000000001;0;100000000000007;100000000000001;100000000000001;10100000000000E;201280000000001;100000000000003;100000000000008;0;100000000000015;100000000000001;
100000000000001;0;380000000000;100000000000015;0;100000000000007;100000000000001;100000000000008;0;107000000000015;0;0;0;100000000000007;100290000000001;100000000000001;100290000000002;100000000000002;100290000000002;100000000000008;290000000000;0;100290000000007;100000000000001;100290000000002;100000000000002;100000000000008;0;0;200000000000000;100000000000001;
100000000000001;0;380000000000;0;0;0;0;0;0;0;0;0;0;0;200280000000001;0;200280000000001;0;200280000000001;0;200280000000001;0;200280000000001;0;200280000000001;0;0;0;0;100000000000015;100000000000001;
100000000000001;0;20038000000000C;0;0;0;0;0;107000000000015;0;0;10700000000000E;0;100290000000015;100000000000015;100290000000015;100000000000015;100290000000015;100000000000015;100290000000015;100000000000015;100290000000015;100000000000015;100290000000015;100000000000015;100290000000015;100000000000015;290000000000;0;0;100000000000001;
100000000000001;107000000000000;3A0000000000;107000000000000;0;0;207000000000004;0;207000000000004;0;200000000000010;10700000000000E;0;200280000000001;0;200280000000001;205000000000004;200280000000001;0;200280000000001;200000000000003;200280000000001;205000000000004;200280000000001;0;200280000000001;0;200000000000001;0;100000000000015;100000000000001;
100000000000001;0;107000000000000;0;107000000000015;100000000000003;100000000000002;100000000000002;100000000000002;100000000000002;100000000000002;100000000000002;100000000000002;100000000000002;100000000000002;100000000000002;100000000000002;100000000000002;100000000000002;100000000000002;100000000000002;100000000000002;100000000000002;100000000000002;100000000000002;100000000000002;100000000000002;100000000000002;100000000000002;100000000000002;100000000000001;
100000000000001;0;390000000000;0;0;100000000000001;100000000000001;100000000000001;100000000000001;0;0;0;0;0;0;0;20400000000000B;0;0;0;0;0;0;0;0;200000000000000;200000000000003;200000000000000;0;0;100000000000001;
100000000000001;0;380000000000;0;0;100000000000007;100000000000001;100000000000008;10000000000000E;0;0;0;0;0;0;0;0;0;0;0;0;204000000000004;0;0;0;200000000000000;200000000000003;200000000000000;0;0;100000000000001;
100000000000001;0;380000000000;0;0;0;100000000000018;10000000000000E;10000000000000E;0;0;0;0;100290000000015;0;10029000000001B;0;10029000000001B;0;10029000000001B;0;0;0;0;0;0;100000000000015;0;0;0;100000000000001;
100000000000001;0;2073A000000000C;0;107000000000015;100000000000003;100000000000002;100000000000002;100000000000004;0;100000000000015;100000000000015;0;204280000000001;207000000000004;204280000000001;207000000000004;204280000000001;207000000000004;204280000000001;0;10000000000000C;100000000000000;0;200000000000004;100000000000000;200000000000000;0;0;200000000000002;100000000000001;
100000000000001;0;107000000000000;0;0;100000000000001;100000000000001;100000000000001;100000000000001;0;0;10000000000000E;0;100290000000015;100000000000015;100290000000015;100000000000015;100290000000015;100000000000015;100290000000015;0;100000000000001;0;100000000000015;100000000000015;0;100000000000015;0;0;0;100000000000001;
100000000000001;10700000000001C;10700000000001C;10700000000001C;100000000000003;100000000000001;100000000000001;100000000000001;100000000000001;0;200000000000010;10000000000000E;0;204280000000001;206000000000004;204280000000001;107000000000000;204280000000001;206000000000004;204280000000001;0;100000000000001;200000000000003;200000000000003;0;0;200000000000000;0;0;20000000000000E;100000000000001;
100000000000001;100000000000002;100000000000002;100000000000002;100000000000001;100000000000001;100000000000001;100000000000001;100000000000001;100000000000002;100000000000002;100000000000002;100000000000002;100000000000002;100000000000002;100000000000004;0;100000000000003;100000000000002;100000000000004;101000000000015;100000000000001;100000000000002;100000000000004;0;0;100000000000015;100000000000015;0;0;100000000000001;
100000000000001;100000000000001;100000000000001;100000000000001;100000000000001;100000000000001;100000000000001;100000000000001;100000000000001;100000000000001;100000000000001;100000000000001;100000000000001;100000000000001;100000000000001;100000000000008;0;100000000000007;100000000000001;100000000000008;0;100000000000007;100000000000001;100000000000001;0;0;0;200000000000000;100000000000000;0;100000000000001;
100000000000001;0;0;20100000000000B;0;0;20100000000000B;0;100000000000001;205000000000009;205000000000009;205000000000009;205000000000009;205000000000009;205000000000009;10100000000000E;0;200000000000003;200000000000003;200000000000003;101000000000015;200000000000000;200000000000000;100000000000001;0;0;0;100000000000015;390000000000;0;100000000000001;
100000000000001;0;0;0;0;0;0;0;100000000000001;200000000000009;200000000000009;200000000000009;205000000000004;200000000000009;200000000000009;10100000000000E;205000000000004;0;0;0;0;0;0;100000000000001;0;0;0;0;380000000000;0;100000000000001;
100000000000001;0;0;0;201000000000003;201000000000003;0;0;100000000000007;100000000000002;100000000000002;100000000000002;100000000000002;100000000000002;100000000000002;100000000000002;100000000000002;100000000000002;100000000000002;100000000000002;100000000000002;100000000000002;100000000000002;100000000000008;0;0;0;0;380000000000;20500000000000D;100000000000001;
100000000000001;201000000000000;0;0;101000000000015;101000000000015;0;0;0;0;10100000000000E;0;290000000000;0;290000000000;0;290000000000;0;290000000000;0;290000000000;0;290000000000;0;0;0;0;0;380000000000;0;100000000000001;
100000000000001;201000000000000;0;0;201000000000003;201000000000003;0;0;0;200000000000010;10100000000000E;205000000000004;201280000000001;205000000000004;201280000000001;205000000000004;201280000000001;205000000000004;201280000000001;205000000000004;201280000000001;205000000000004;201280000000001;0;0;100000000000000;0;0;2053A000000000C;0;100000000000001;
100000000000001;201000000000000;0;100000000000005;100000000000002;100000000000002;100000000000002;100000000000002;100000000000002;100000000000002;100000000000002;100000000000002;100000000000002;100000000000002;100000000000002;100000000000002;100000000000002;100000000000002;100000000000002;100000000000002;100000000000002;100000000000002;100000000000002;100000000000002;100000000000004;0;10500000000001A;0;105000000000000;0;100000000000001;
100000000000001;101000000000015;0;0;0;0;20500000000000B;0;0;0;0;0;100000000000001;100000000000001;100000000000001;100000000000001;100000000000001;100000000000001;100000000000001;100000000000001;100000000000001;100000000000001;100000000000001;100000000000001;100000000000001;0;0;0;0;0;100000000000001;
100000000000001;0;0;0;0;0;0;0;0;0;0;0;100000000000007;100000000000001;100000000000001;100000000000001;100000000000001;100000000000001;100000000000001;100000000000001;100000000000001;100000000000001;100000000000001;100000000000001;100000000000001;0;0;0;0;0;100000000000001;
100000000000001;0;101000000000015;200000000000000;200000000000000;200000000000000;200000000000000;0;0;0;0;0;0;0;10500000000000E;200000000000000;200290000000000;200000000000000;200290000000000;200000000000000;200290000000000;200000000000000;200290000000000;100000000000001;100000000000001;10500000000001C;10500000000001C;10500000000001C;10500000000001C;10500000000001C;100000000000001;
100000000000001;0;201000000000004;200000000000000;200000000000000;200000000000000;200000000000000;0;105000000000000;0;105000000000000;0;0;200000000000010;10500000000000E;0;200280000000001;206000000000004;200280000000001;205000000000004;200280000000001;207000000000004;200280000000001;100000000000001;100000000000001;100000000000002;100000000000002;100000000000002;100000000000002;100000000000002;100000000000001;
100000000000001;100000000000002;100000000000002;100000000000002;100000000000002;100000000000002;100000000000002;100000000000004;0;0;390000000000;0;100000000000003;100000000000002;100000000000002;100000000000002;100000000000002;100000000000002;100000000000002;100000000000002;100000000000002;100000000000002;100000000000002;100000000000001;100000000000001;100000000000001;100000000000001;100000000000001;100000000000001;100000000000001;100000000000001;
100000000000001;100000000000001;100000000000001;100000000000001;100000000000001;100000000000001;100000000000001;100000000000001;0;0;380000000000;0;100000000000001;100000000000001;100000000000001;100000000000001;100000000000001;100000000000001;100000000000001;100000000000001;100000000000001;100000000000001;100000000000001;100000000000001;100000000000001;100000000000001;100000000000001;100000000000001;100000000000001;100000000000001;100000000000001;
100000000000001;100000000000001;100000000000001;100000000000001;100000000000001;100000000000001;100000000000001;100000000000001;0;0;380000000000;0;100000000000001;100000000000001;100000000000001;100000000000001;100000000000001;100000000000001;100000000000001;100000000000001;100000000000001;100000000000001;100000000000001;100000000000001;100000000000001;100000000000001;100000000000001;100000000000001;100000000000001;100000000000001;100000000000001;
100000000000001;100000000000001;100000000000001;100000000000001;100000000000001;100000000000001;100000000000001;100000000000008;0;0;20538000000000C;0;100000000000007;100000000000001;100000000000001;100000000000001;100000000000001;100000000000001;100000000000001;100000000000001;100000000000001;100000000000001;100000000000001;100000000000001;100000000000001;100000000000001;100000000000001;100000000000001;100000000000001;100000000000001;100000000000001;
100000000000001;2062B0000000007;2C0000000000;0;290000000000;0;290000000000;0;290000000000;0;290000000000;0;290000000000;0;290000000000;0;0;0;0;0;0;0;0;205000000000009;205000000000009;205000000000009;205000000000009;0;0;100000000000001;100000000000001;
100000000000001;2B0000000000;2002C0000000001;0;200280000000001;0;200280000000001;0;200280000000001;0;200280000000001;0;200280000000001;0;200280000000001;0;205000000000004;0;100000000000000;0;106000000000000;205000000000004;205000000000009;205000000000009;205000000000009;205000000000009;205000000000009;205000000000009;206000000000004;100000000000001;100000000000001;
100000000000001;100000000000002;100000000000002;100000000000002;100000000000002;100000000000002;100000000000002;100000000000002;100000000000002;100000000000002;100000000000002;100000000000002;100000000000002;100000000000002;100000000000002;100000000000002;100000000000002;100000000000006;0;0;0;100000000000005;100000000000002;100000000000002;100000000000002;100000000000002;100000000000002;100000000000002;100000000000002;100000000000001;100000000000001;
100000000000001;0;207000000000000;0;0;0;0;0;0;0;0;0;0;0;0;200000000000003;0;0;0;105000000000015;0;0;0;100000000000001;0;0;0;20300000000000B;0;0;100000000000001;
100000000000001;0;207000000000000;0;0;0;0;0;0;0;0;207000000000003;0;105000000000000;0;207000000000000;0;205000000000004;100000000000000;0;207000000000003;207000000000003;207000000000000;100000000000001;0;290000000000;0;0;290000000000;0;100000000000001;
100000000000001;0;107000000000015;0;0;0;0;290000000000;0;0;0;207000000000003;0;100000000000003;100000000000002;100000000000002;100000000000002;100000000000002;100000000000004;10500000000001C;100000000000003;100000000000002;100000000000002;100000000000001;100000000000000;200280000000001;203000000000004;0;200280000000001;100000000000000;100000000000001;
100000000000001;0;207000000000000;0;0;10000000000000E;206000000000004;200280000000001;206000000000004;10000000000000E;0;107000000000015;0;100000000000001;100000000000001;100000000000001;100000000000001;100000000000001;100000000000001;100000000000002;100000000000001;100000000000001;100000000000001;100000000000001;0;103000000000015;103000000000015;100000000000015;103000000000015;0;100000000000001;
100000000000001;0;107000000000015;0;0;100000000000005;100000000000002;100000000000002;100000000000002;100000000000006;0;0;0;100000000000007;100000000000001;100000000000001;100000000000001;100000000000001;100000000000001;100000000000001;100000000000001;100000000000001;100000000000001;100000000000008;0;0;0;0;0;0;100000000000001;
100000000000001;0;207000000000000;0;0;0;0;0;0;0;0;0;0;0;0;0;0;0;0;201000000000003;0;0;0;0;0;0;0;103390000000015;0;0;100000000000001;
100000000000001;0;107000000000015;0;0;0;0;0;0;0;0;207000000000000;0;204000000000004;0;0;0;0;0;200000000000003;0;0;0;0;0;0;0;380000000000;0;201000000000003;100000000000001;
100000000000001;0;207000000000000;0;207000000000000;0;200000000000003;200000000000003;200000000000003;0;100000000000003;100000000000002;100000000000004;104000000000000;0;0;290000000000;0;0;10100000000000E;0;0;0;100000000000003;100000000000002;100000000000004;0;380000000000;0;201000000000003;100000000000001;
100000000000001;0;107000000000015;0;10000000000000E;0;100290000000015;100000000000015;100290000000015;0;100000000000001;100000000000001;100000000000001;205000000000004;205000000000004;205000000000004;201280000000001;206000000000004;206000000000004;10100000000000E;200000000000011;0;100000000000003;100000000000001;100000000000001;100000000000008;0;380000000000;0;100000000000003;100000000000001;
100000000000001;0;0;200000000000010;10000000000000E;207000000000004;200280000000001;206000000000004;200280000000001;206000000000004;100000000000001;100000000000001;100000000000001;100000000000002;100000000000002;100000000000002;100000000000002;100000000000002;100000000000002;100000000000002;100000000000002;100000000000002;100000000000001;100000000000001;0;201000000000004;0;20038000000000C;0;100000000000001;100000000000001;
100000000000001;100000000000002;100000000000002;100000000000002;100000000000002;100000000000002;100000000000002;100000000000002;100000000000002;100000000000002;100000000000001;100000000000001;100000000000001;100000000000001;100290000000001;100000000000001;100000000000001;100000000000001;100000000000001;100000000000001;100000000000001;100000000000001;100000000000001;100000000000001;0;0;0;380000000000;0;100000000000001;100000000000001;
100000000000001;2002B000000000F;2002B0000000006;2B0000000000;100000000000001;100000000000001;100000000000001;100000000000001;0;0;204280000000001;0;204280000000001;0;204280000000001;0;0;0;0;204000000000004;204000000000000;100000000000001;100000000000001;100000000000001;0;0;0;3A0000000000;0;100000000000001;100000000000001;
100000000000001;2B0000000000;2002B0000000000;2B0000000000;100000000000001;100000000000001;100000000000001;100000000000001;0;0;104000000000015;104000000000015;104000000000015;104000000000015;104000000000015;0;0;0;204000000000000;0;204000000000000;100000000000001;100000000000001;100000000000001;0;0;0;100000000000015;0;100000000000001;100000000000001;
100000000000001;0;200000000000000;0;100000000000001;100000000000001;100000000000001;100000000000008;0;0;0;200000000000009;20400000000000D;200000000000009;0;0;0;204000000000004;204000000000000;0;204000000000000;100000000000007;100000000000001;100000000000008;0;0;100000000000015;0;0;100000000000001;100000000000001;
100000000000001;0;100000000000015;200000000000005;100000000000007;100000000000008;0;20029000000000B;0;290000000000;0;290000000000;104000000000015;290000000000;0;290000000000;0;0;204000000000000;0;204000000000000;0;104000000000017;0;0;0;0;0;0;100000000000001;100000000000001;
100000000000001;0;200000000000000;0;10000000000000E;10000000000000E;206000000000004;200280000000001;0;200280000000001;206000000000004;200280000000001;0;200280000000001;0;200280000000001;206000000000004;100000000000003;100000000000002;100000000000002;100000000000002;100000000000002;100000000000002;100000000000002;100000000000002;100000000000002;100000000000004;10000000000001C;10000000000001C;100000000000001;100000000000001;
100000000000001;0;100000000000015;0;10000000000000E;10000000000000E;100000000000015;100000000000015;100000000000015;100000000000015;100000000000015;100000000000015;100000000000015;100000000000015;100000000000015;100000000000015;100000000000015;100000000000001;0;10000000000000D;0;20000000000000B;0;0;0;0;100000000000007;100000000000002;100000000000002;100000000000001;100000000000001;
100000000000001;0;100000000000000;0;10000000000000E;10000000000000E;200000000000009;0;200000000000009;207000000000004;200000000000009;0;200000000000009;207000000000004;200000000000009;0;200000000000009;100000000000001;0;0;0;0;0;0;0;0;0;0;0;0;100000000000001;
100000000000001;0;390000000000;0;100000000000003;100000000000002;100000000000002;100000000000002;100000000000002;100000000000002;100000000000002;100000000000002;100000000000002;100000000000002;100000000000002;100000000000002;100000000000002;100000000000001;0;0;0;0;0;0;204000000000004;0;0;200000000000003;0;20100000000640E;100000000000001;
100000000000001;0;380000000000;0;100000000000007;100000000000001;100000000000001;100000000000001;100000000000001;100000000000001;100000000000001;100000000000001;100000000000001;100000000000001;100000000000001;100000000000001;100000000000001;100000000000001;0;100000000000015;0;100000000000003;100000000000002;100000000000004;0;100000000000015;0;0;204000000006404;0;100000000000001;
100000000000001;0;20138000000640C;0;20000000000000B;0;0;201000000006404;0;0;200000000006400;0;0;0;100000000000001;100000000000001;100000000000001;100000000000001;0;200000000000003;0;100000000000007;100000000000001;100000000000001;0;200000000000003;0;10000000000001A;0;20100000000640E;100000000000001;
100000000000001;0;380000000000;0;0;0;0;200000000006403;200000000006403;200000000006409;200000000006400;200000000006409;0;0;100000000000007;100000000000001;100000000000001;100000000000008;0;200000000000003;0;0;0;100000000000001;0;100000000000015;0;0;0;0;100000000000001;
100000000000001;0;3A0000000000;0;0;0;0;200000000006403;200000000006403;0;200000000006400;0;0;290000000000;20029000000000B;0;0;20029000000000B;100290000000015;100000000000015;0;205000000000004;0;100000000000001;0;0;0;10000000000000C;0;0;100000000000001;
100000000000001;0;10000000000000D;10000000000000E;0;0;0;10000000000640F;10000000000640F;10000000000640F;10000000000000C;0;100000000000000;207280000000001;207280000000001;205000000000004;207000000000004;207280000000001;207280000000001;107000000000000;10000000000000E;10000000000000E;10000000000000E;100000000000001;104000000006400;10000000000000C;0;100000000000001;0;0;100000000000001;
100000000000001;0;0;10000000000000E;100000000000015;200000000000000;200000000000000;200000000000000;200000000000000;200290000000000;100000000000001;0;10000000000000C;100000000000015;100290000000015;100000000000015;100290000000015;100000000000015;100000000000015;0;10000000000000E;0;0;100000000000001;0;100000000000001;0;100000000000001;0;0;100000000000001;
100000000000001;0;200000000000010;10000000000000E;206000000000004;206000000000004;207000000000004;206000000000004;0;207280000000001;100000000000001;0;100000000000001;205000000000004;207280000000001;205000000000004;207280000000001;0;205000000000004;0;10000000000000E;200000000000011;0;100000000000001;0;100000000000001;0;100000000000001;0;0;100000000000001;
100000000000001;100000000000015;100000000000015;100000000000005;100000000000002;100000000000002;100000000000002;100000000000002;100000000000002;100000000000002;100000000000008;0;100000000000001;100000000000002;100000000000002;100000000000002;100000000000002;100000000000002;100000000000002;100000000000002;100000000000002;100000000000002;100000000000002;100000000000008;0;100000000000001;0;100000000000009;0;0;100000000000001;
100000000000001;200000000000005;0;200000000000000;200000000000003;200000000000000;200000000000003;200000000000000;200000000000003;200000000000000;200000000000003;200000000000000;100000000000001;100000000000001;100000000000001;100000000000001;100000000000001;100000000000001;0;0;20100000000000B;0;0;20100000000000B;0;100000000000009;100000000000000;0;0;0;100000000000001;
100000000000001;100000000000002;100000000000002;100000000000002;100000000000002;100000000000002;100000000000002;100000000000002;100000000000002;100000000000002;100000000000002;100000000000002;100000000000001;100000000000001;100000000000001;100000000000001;100000000000001;100000000000008;0;0;0;0;0;0;0;0;390000000000;0;0;0;100000000000001;
100000000000001;100000000000001;100000000000008;0;0;0;0;0;0;0;0;0;0;201000000000004;0;0;0;0;200000000000000;0;200000000000000;0;0;0;0;0;380000000000;0;10000000000000C;207000000006402;100000000000001;
100000000000001;0;10000000000000D;0;0;201000000000000;0;0;0;0;0;0;0;0;0;0;201000000000000;0;200000000000000;0;200000000000000;0;0;200000000000000;0;0;20738000000640C;0;100000000000001;0;100000000000001;
100000000000001;20000000000000F;0;0;0;0;0;0;0;20000000000000D;0;207290000006400;207000000006400;207290000006400;207000000006400;207290000006400;10000000000000C;290000000000;10700000000640F;290000000000;10700000000640F;290000000000;0;200000000000000;0;0;3A0000000000;200000000000000;100000000000001;0;100000000000001;
100000000000001;0;0;0;0;10000000000000C;0;0;0;0;0;200280000000001;207000000000004;200280000000001;207000000000004;200280000000001;100000000000001;200280000000001;207000000000004;200280000000001;207000000000004;200280000000001;0;200000000000000;0;0;107000000006400;200000000000000;100000000000001;10700000000641C;100000000000001;
100000000000001;0;100000000000015;100000000000015;0;100000000000001;0;0;0;10000000000000E;0;100290000000015;100000000000015;100290000000015;100000000000015;100290000000015;100000000000001;100290000000015;100000000000015;100290000000015;100000000000015;100290000000015;0;10000000000000E;0;0;100000000000003;100000000000002;100000000000001;100000000000002;100000000000001;
100000000000001;300000000000001;0;0;0;100000000000001;0;0;200000000000010;10000000000000E;207000000000004;200280000000001;207000000000004;200280000000001;207000000000004;200280000000001;100000000000001;200280000000001;207000000000004;200280000000001;207000000000004;200280000000001;0;10000000000000E;200000000000011;0;100000000000001;100000000000001;100000000000001;100000000000001;100000000000001;
100000000000001;100000000000001;100000000000001;100000000000001;100000000000001;100000000000001;100000000000001;100000000000001;100000000000001;100000000000001;100000000000001;100000000000001;100000000000001;100000000000001;100000000000001;100000000000001;100000000000001;100000000000001;100000000000001;100000000000001;100000000000001;100000000000001;100000000000001;100000000000001;100000000000001;100000000000001;100000000000001;100000000000001;100000000000001;100000000000001;100000000000001;
