0;100000000000001;100000000000001;100000000000001;100000000000001;100000000000001;100000000000001;100000000000001;100000000000001;100000000000001;100000000000001;100000000000001;100000000000001;100000000000001;100000000000001;100000000000001;100000000000001;100000000000001;100000000000001;100000000000001;100000000000001;100000000000001;100000000000001;100000000000001;100000000000001;1000E0000000001;100000000000001;100000000000001;100000000000001;100000000000001;100000000000001;100000000000001;1003F0000000001;1003F0000000001;100000000000001;100000000000001;100000000000001;1003F0000000001;100000000000001;1003F0000000001;100400000000001;100000000000001;100000000000001;100000000000001;100000000000001;100000000000001;100000000000001;100000000000001;100000000000001;1000C0000000001;100000000000001;1000C0000000001;100000000000001;100000000000001;100000000000001;100000000000001;100000000000001;100000000000001;100000000000001;100000000000001;100000000000001;100000000000001;100000000000001;100000000000001;100000000000001;100000000000001;100000000000001;100000000000001;100000000000001;100000000000001;100000000000001;1000D0000000001;100000000000001;100000000000001;100000000000001;100000000000001;100000000000001;100000000000001;100000000000001;100000000000001;100000000000001;100000000000001;100000000000001;100000000000001;100000000000001;100000000000001;100000000000001;100000000000001;100000000000001;100000000000001;100000000000001;100000000000001;100000000000001;100000000000001;100000000000001;100000000000001;100000000000001;100000000000001;100000000000001;100000000000001;100000000000001;100000000000001;100000000000001;100000000000001;100000000000001;100000000000001;100000000000001;100000000000001;100000000000001;100000000000001;100000000000001;100000000000001;100000000000001;100000000000001;100000000000001;100000000000001;1003F0000000001;1003F0000000001;1003F0000000001;1003F0000000001;1003F0000000001;100400000000001;100000000000001;100000000000001;100000000000001;100000000000001;100000000000001;100000000000001;100000000000001;100000000000001;100000000000001;100000000000001;1003B0000000001;1003B0000000001;100000000000001;100000000000001;
100000000000001;0;0;0;0;0;0;0;0;0;0;0;0;0;0;0;0;0;0;0;0;0;D0000000000;C0000000000;C0000000000;E0000000000;0;0;0;0;0;0;410000000000;3F0000000000;400000000000;0;410000000000;3F0000000000;3F0000000000;3F0000000000;400000000000;0;0;0;0;0;0;0;0;0;0;0;0;0;0;0;0;0;0;0;0;0;D0000000000;C0000000000;E0000000000;0;0;0;0;0;0;D0000000000;C0000000000;C0000000000;E0000000000;0;0;0;0;0;0;0;0;0;0;0;0;0;0;0;0;0;0;0;0;0;0;0;0;0;0;0;0;0;0;0;0;0;0;0;0;0;0;0;0;410000000000;3F0000000000;3F0000000000;3F0000000000;3F0000000000;3F0000000000;400000000000;0;0;0;0;0;0;0;0;0;0;3C0000000000;3B0000000000;3B0000000000;100000000000001;
100000000000001;0;0;0;0;0;0;0;0;0;0;0;0;0;0;0;0;0;0;0;0;0;D0000000000;C0000000000;C0000000000;E0000000000;0;0;0;0;0;0;410000000000;3F0000000000;400000000000;0;410000000000;3F0000000000;3F0000000000;3F0000000000;400000000000;0;0;0;0;0;0;0;0;0;0;0;0;0;0;0;0;0;0;0;0;0;D0000000000;C0000000000;E0000000000;0;0;0;0;0;0;D0000000000;C0000000000;C0000000000;E0000000000;0;0;0;0;0;0;0;0;0;0;0;0;0;0;0;0;0;0;0;0;0;0;0;0;0;0;0;0;0;0;0;0;0;0;0;0;0;0;0;0;410000000000;3F0000000000;3F0000000000;3F0000000000;3F0000000000;3F0000000000;400000000000;0;0;0;0;0;0;0;0;0;0;3C0000000000;3B0000000000;3B0000000000;100000000000001;
100000000000001;0;0;0;0;0;0;0;0;0;0;0;0;0;0;0;0;0;0;0;0;0;D0000000000;C0000000000;C0000000000;E0000000000;0;0;0;0;0;0;410000000000;3F0000000000;400000000000;0;410000000000;3F0000000000;3F0000000000;3F0000000000;400000000000;0;0;0;0;0;0;0;0;0;0;0;0;0;0;0;0;0;0;0;0;0;D0000000000;C0000000000;E0000000000;0;0;0;0;0;0;D0000000000;C0000000000;C0000000000;E0000000000;0;0;0;0;0;0;0;0;0;0;0;0;0;0;0;0;0;0;0;0;0;0;0;0;0;0;0;0;0;0;0;0;0;0;0;0;0;0;0;0;410000000000;3F0000000000;3F0000000000;3F0000000000;3F0000000000;3F0000000000;400000000000;0;0;0;0;0;0;0;0;0;0;3C0000000000;3B0000000000;3B0000000000;100000000000001;
100000000000001;0;0;0;0;0;0;0;0;0;0;0;0;0;0;0;0;0;0;0;0;0;D0000000000;C0000000000;C0000000000;E0000000000;0;0;0;0;0;0;410000000000;3F0000000000;400000000000;0;410000000000;3F0000000000;3F0000000000;3F0000000000;400000000000;0;0;0;0;0;0;0;0;0;0;0;0;0;0;0;0;0;0;0;0;0;D0000000000;C0000000000;E0000000000;0;0;0;0;0;0;D0000000000;C0000000000;C0000000000;E0000000000;0;0;0;0;0;0;0;0;0;0;0;0;0;0;0;0;0;0;0;0;0;0;0;0;0;100000000000;120000000000;120000000000;120000000000;120000000000;F0000000000;0;0;0;0;0;0;0;0;0;410000000000;3F0000000000;3F0000000000;3F0000000000;3F0000000000;3F0000000000;400000000000;0;0;0;0;0;0;0;0;0;0;3C0000000000;3B0000000000;3B0000000000;100000000000001;
100000000000001;0;0;0;0;0;0;0;0;0;0;0;0;0;0;0;0;0;0;0;0;0;D0000000000;C0000000000;C0000000000;E0000000000;0;0;0;0;0;0;410000000000;3F0000000000;400000000000;0;410000000000;3F0000000000;3F0000000000;3F0000000000;400000000000;0;0;0;0;0;0;0;0;0;0;0;0;0;0;0;0;0;0;0;0;0;D0000000000;C0000000000;E0000000000;0;0;0;0;0;0;D0000000000;C0000000000;C0000000000;E0000000000;0;0;0;0;0;0;0;0;0;0;0;0;0;0;0;0;0;0;0;0;0;0;0;0;0;D0000000000;C0000000000;C0000000000;C0000000000;C0000000000;E0000000000;0;0;0;0;0;0;0;0;0;410000000000;3F0000000000;3F0000000000;3F0000000000;3F0000000000;3F0000000000;400000000000;0;0;0;0;0;0;0;0;0;0;3C0000000000;3B0000000000;3B0000000000;100000000000001;
100000000000001;0;0;0;0;0;0;0;0;0;0;0;0;0;0;0;0;0;0;0;0;0;D0000000000;C0000000000;C0000000000;E0000000000;0;0;0;0;0;0;410000000000;3F0000000000;400000000000;0;410000000000;3F0000000000;3F0000000000;3F0000000000;400000000000;0;0;0;0;0;0;0;0;0;0;0;0;0;0;0;0;0;0;0;0;0;D0000000000;C0000000000;E0000000000;0;0;0;0;0;0;D0000000000;C0000000000;C0000000000;E0000000000;0;0;0;0;0;0;0;0;0;0;0;0;0;0;0;0;0;0;0;0;0;0;0;0;0;D0000000000;C0000000000;C0000000000;C0000000000;C0000000000;E0000000000;0;0;0;0;0;0;0;0;0;410000000000;3F0000000000;3F0000000000;3F0000000000;3F0000000000;3F0000000000;400000000000;0;0;0;0;0;0;0;0;0;0;3C0000000000;3B0000000000;3B0000000000;100000000000001;
100000000000001;0;0;0;0;0;0;0;0;0;0;0;0;0;0;0;0;0;0;0;0;0;D0000000000;C0000000000;C0000000000;E0000000000;0;0;0;0;0;0;410000000000;3F0000000000;400000000000;0;410000000000;3F0000000000;3F0000000000;3F0000000000;400000000000;0;0;0;0;0;0;0;0;0;0;0;0;0;0;0;0;0;0;0;0;0;D0000000000;C0000000000;E0000000000;0;0;0;0;0;0;D0000000000;C0000000000;C0000000000;E0000000000;0;0;0;0;0;0;0;0;0;0;0;0;0;0;0;0;0;0;0;0;0;0;0;0;0;D0000000000;C0000000000;C0000000000;C0000000000;C0000000000;E0000000000;0;0;0;0;0;0;0;0;0;410000000000;3F0000000000;3F0000000000;3F0000000000;3F0000000000;3F0000000000;400000000000;0;0;0;0;0;0;0;0;0;0;3C0000000000;3B0000000000;3B0000000000;100000000000001;
100000000000001;0;0;0;0;0;0;0;0;0;0;0;0;0;0;0;0;0;0;0;0;0;D0000000000;C0000000000;C0000000000;E0000000000;0;0;0;0;0;0;410000000000;3F0000000000;400000000000;0;410000000000;3F0000000000;3F0000000000;3F0000000000;400000000000;0;0;0;0;0;0;0;0;0;0;0;0;0;0;0;0;0;0;0;0;0;D0000000000;C0000000000;E0000000000;0;0;0;0;0;0;D0000000000;C0000000000;C0000000000;E0000000000;0;0;0;0;0;0;0;0;0;0;0;0;0;0;0;0;0;0;0;0;0;0;0;0;0;D0000000000;C0000000000;C0000000000;C0000000000;C0000000000;E0000000000;0;0;0;0;0;0;0;0;0;410000000000;3F0000000000;3F0000000000;3F0000000000;3F0000000000;3F0000000000;400000000000;0;0;0;0;0;0;0;0;0;0;3C0000000000;3B0000000000;3B0000000000;100000000000001;
100000000000001;0;0;0;0;0;0;0;0;0;0;0;0;0;0;0;0;0;0;0;0;0;D0000000000;C0000000000;C0000000000;E0000000000;0;0;0;0;0;0;410000000000;3F0000000000;400000000000;0;410000000000;3F0000000000;3F0000000000;3F0000000000;400000000000;0;0;0;0;0;100000000000;120000000000;120000000000;120000000000;120000000000;120000000000;120000000000;120000000000;120000000000;F0000000000;0;0;0;0;0;0;D0000000000;C0000000000;E0000000000;0;0;0;0;0;0;D0000000000;C0000000000;C0000000000;E0000000000;0;0;0;0;0;0;0;0;0;0;0;0;0;0;0;0;0;0;0;0;0;0;0;0;0;D0000000000;C0000000000;C0000000000;C0000000000;C0000000000;E0000000000;0;0;0;0;0;0;0;0;0;410000000000;3F0000000000;3F0000000000;3F0000000000;3F0000000000;3F0000000000;400000000000;0;0;0;0;0;0;0;0;0;0;3C0000000000;3B0000000000;3B0000000000;100000000000001;
100000000000001;0;0;0;0;0;0;0;0;0;0;0;0;0;0;0;0;0;0;0;0;0;D0000000000;C0000000000;C0000000000;E0000000000;0;0;0;0;0;0;410000000000;3F0000000000;400000000000;0;410000000000;3F0000000000;3F0000000000;3F0000000000;400000000000;0;0;0;0;0;D0000000000;C0000000000;C0000000000;C0000000000;1D0000000000;1E0000000000;C0000000000;C0000000000;C0000000000;E0000000000;0;0;0;0;0;0;D0000000000;C0000000000;E0000000000;0;0;0;0;0;0;D0000000000;C0000000000;110000000000;E0000000000;0;0;0;0;0;0;0;0;0;0;0;0;0;0;0;0;0;0;0;0;0;0;0;0;0;D0000000000;C0000000000;C0000000000;C0000000000;C0000000000;E0000000000;0;0;0;0;0;0;0;0;0;410000000000;3F0000000000;3F0000000000;3F0000000000;3F0000000000;3F0000000000;400000000000;0;0;0;0;0;0;0;0;0;0;3C0000000000;3B0000000000;3B0000000000;100000000000001;
100000000000001;0;0;0;0;0;0;0;0;0;0;0;0;0;0;0;0;0;0;0;0;0;D0000000000;C0000000000;C0000000000;E0000000000;0;0;0;0;0;0;410000000000;3F0000000000;400000000000;0;410000000000;3F0000000000;3F0000000000;3F0000000000;400000000000;0;0;0;0;0;D0000000000;C0000000000;C0000000000;C0000000000;1F0000000000;200000000000;C0000000000;C0000000000;C0000000000;E0000000000;0;0;0;0;0;0;D0000000000;C0000000000;E0000000000;0;0;0;0;0;0;D0000000000;C0000000000;C0000000000;E0000000000;0;0;0;0;0;0;0;0;0;0;0;0;0;0;0;0;0;0;0;0;0;0;0;0;0;D0000000000;C0000000000;210000000000;220000000000;C0000000000;E0000000000;0;0;0;0;0;0;0;0;0;410000000000;3F0000000000;3F0000000000;3F0000000000;3F0000000000;3F0000000000;400000000000;0;0;0;0;0;0;0;0;0;0;3C0000000000;3B0000000000;3B0000000000;100000000000001;
100000000000001;0;0;0;0;0;0;0;0;0;0;0;0;0;201000000000012;0;200000000000000;0;0;0;0;0;2000D0000000000;2000C0000000000;2000C0000000000;2000E0000000000;0;0;0;0;0;0;410000000000;3F0000000000;400000000000;204000000000012;410000000000;3F0000000000;3F0000000000;3F0000000000;400000000000;0;0;0;0;0;D0000000000;C0000000000;C0000000000;C0000000000;C0000000000;C0000000000;C0000000000;C0000000000;C0000000000;E0000000000;0;0;0;0;0;0;D0000000000;C0000000000;E0000000000;0;0;0;0;0;0;D0000000000;C0000000000;C0000000000;E0000000000;0;0;0;0;0;0;0;0;0;0;0;0;0;0;0;0;0;0;0;0;0;0;0;0;0;D0000000000;C0000000000;230000000000;240000000000;C0000000000;E0000000000;0;0;20A000000000012;0;0;0;0;0;0;410000000000;3F0000000000;3F0000000000;3F0000000000;3F0000000000;3F0000000000;400000000000;0;0;0;0;0;0;0;0;0;0;3C0000000000;3B0000000000;3B0000000000;100000000000001;
100000000000001;0;0;0;0;0;0;0;0;0;0;0;100000000000003;100000000000002;100000000000002;100000000000004;200000000000000;0;0;0;0;0;2000D0000000000;2000C0000000000;2000C0000000000;2000E0000000000;0;0;0;0;0;0;410000000000;3F0000000000;400000000000;100000000000003;100410000000004;1003F0000000004;1003F0000000010;1003F0000000010;100400000000003;100000000000004;0;200000000000003;0;0;1000D0000000000;C0000000000;C0000000000;C0000000000;2000C0000000004;C0000000000;C0000000000;C0000000000;2060C0000000012;1000E0000000000;0;0;0;0;0;0;D0000000000;C0000000000;E0000000000;200000000000000;200000000000000;200000000000000;200000000000000;200000000000000;0;D0000000000;C0000000000;110000000000;E0000000000;0;0;0;0;0;0;0;0;0;0;0;0;0;A0000000000;0;0;0;0;0;0;200000000000000;200000000000000;200000000000000;200000000000000;0;D0000000000;C0000000000;C0000000000;C0000000000;C0000000000;E0000000000;0;10000000000000E;10000000000000E;10000000000000E;10000000000000E;10000000000000E;0;0;100000000000003;100410000000004;3F0000000000;3F0000000000;3F0000000000;3F0000000000;3F0000000000;400000000000;0;0;0;0;0;0;0;0;0;290000000000;3C0000000000;3B0000000000;3B0000000000;100000000000001;
100000000000001;0;0;0;0;A0000000000;0;0;0;0;0;70000000000;100000000000001;100000000000001;100000000000001;100000000000001;200000000000000;0;0;0;0;0;100170000000015;100150000000015;100150000000015;100140000000015;0;0;0;0;200000000000003;200000000000003;410000000000;3F0000000000;400000000000;100000000000001;100000000000001;1003F0000000001;1003F0000000002;1003F0000000002;100400000000001;100000000000001;0;0;0;0;100000000000005;100000000000002;100000000000002;100000000000002;100000000000002;100000000000002;100000000000002;100000000000002;100000000000002;100000000000004;0;0;0;B0000000000;0;0;D0000000000;C0000000000;E0000000000;0;0;0;0;0;0;D0000000000;2070C0000000012;C0000000000;E0000000000;50000000000;0;0;0;0;0;0;0;0;0;0;80000000000;80000000000;90000000000;208000000000012;100000000000000;0;200000000000004;10000000000000E;0;10000000000000E;200000000000000;200000000000004;10000000000000E;0;D0000000000;C0000000000;2090C0000000012;C0000000000;100150000000015;100140000000015;0;10000000000000E;10000000000000E;200000000000003;200000000000003;10000000000000E;100000000000003;100000000000002;100000000000001;100410000000001;3F0000000000;3F0000000000;3F0000000000;3F0000000000;3F0000000000;400000000000;0;0;0;0;0;0;10000000000000E;200000000000004;20B000000000012;200280000000001;3C0000000000;3B0000000000;3003B0000000002;100000000000001;
100000000000001;0;0;0;0;90000000000;10000000000000C;0;0;0;30000000000;100000000000003;100000000000001;100000000000001;100000000000001;100000000000001;10000000000000E;0;0;100000000000000;0;50000000000;D0000000000;2000C0000000004;C0000000000;E0000000000;0;100000000000000;0;320000000000;330000000000;0;410000000000;3F0000000000;100400000000003;100000000000001;100000000000001;100000000000001;100000000000001;100000000000001;100000000000001;100000000000001;0;0;100000000000015;0;10000000000000E;2003C0000000000;2003E0000000000;2003B0000000000;2003E0000000000;2003B0000000000;100000000000001;100000000000001;100000000000001;100000000000001;0;0;0;90000000000;80000000000;70000000000;100000000000003;100000000000002;1000E0000000004;100000000000010;10000000000000C;100000000000010;10000000000000C;100000000000010;100000000000003;1000D0000000002;1000C0000000002;1000C0000000002;1000E0000000002;100000000000004;0;200000000000000;200000000000000;200000000000000;200000000000000;200000000000000;200000000000000;200000000000000;0;100000000000003;100000000000002;100000000000002;100000000000002;100000000000004;0;100000000000003;100000000000002;100000000000004;200000000000000;100000000000015;100000000000015;100000000000015;100000000000015;200000000000000;100000000000003;100000000000002;1000C0000000004;C0000000000;C0000000000;E0000000000;0;10000000000000E;10000000000000E;200000000000005;200000000000003;100000000000003;100000000000001;100000000000001;100000000000001;1003F0000000001;1003F0000000004;3F0000000000;3F0000000000;3F0000000000;3F0000000000;400000000000;0;0;0;0;0;0;100000000000003;100000000000002;100000000000002;100000000000002;1003B0000000002;1003B0000000002;1003B0000000002;100000000000001;
100000000000001;300000000000001;0;70000000000;200000000000012;100000000000003;100000000000001;70000000000;70000000000;70000000000;100000000000003;100000000000001;100000000000001;100000000000001;100000000000001;100000000000001;10004000000000E;10004000000000E;202040000000012;40000000000;100000000000003;100000000000002;100000000000002;100000000000002;100000000000002;100000000000002;100000000000004;0;203000000000012;340000000000;350000000000;0;410000000000;1003F0000000003;100400000000001;100000000000001;100000000000001;100000000000001;100000000000001;100000000000001;100000000000001;100000000000001;0;205000000000012;0;0;10000000000000E;3C0000000000;3B0000000000;2003B0000000004;3B0000000000;2003B0000000003;100000000000001;100000000000001;100000000000001;100000000000001;10000000000001C;10000000000001C;100000000000003;100000000000002;100000000000002;100000000000002;100000000000001;100000000000001;100000000000001;100000000000002;100000000000001;100000000000002;100000000000001;100000000000002;100000000000001;100000000000001;100000000000001;100000000000001;100000000000001;100000000000001;40000000000;40000000000;200040000000004;40000000000;200040000000004;40000000000;200040000000004;40000000000;40000000000;100000000000001;100000000000001;100000000000001;100000000000001;100000000000001;10000000000001C;100000000000001;100000000000001;100000000000001;200000000000000;200000000000000;200000000000000;200000000000000;200000000000000;200000000000000;100000000000001;100000000000001;1000C0000000001;1000C0000000002;1000C0000000002;100000000000004;10000000000001C;100000000000003;100000000000002;100000000000002;100000000000002;100000000000001;100000000000001;100000000000001;100000000000001;100000000000001;100000000000001;1003F0000000004;3F0000000000;3F0000000000;2003F0000000004;400000000000;200000000000004;0;200000000000004;0;0;100000000000003;100000000000001;100000000000001;100000000000001;100000000000001;100000000000001;100000000000001;100000000000001;100000000000001;
100000000000001;100000000000002;100000000000002;100000000000002;100000000000002;100000000000001;100000000000001;100000000000002;100000000000002;100000000000002;100000000000001;100000000000001;100000000000001;100000000000001;100000000000001;100000000000001;100000000000002;100000000000002;100000000000002;100000000000002;100000000000001;100000000000001;100000000000001;100000000000001;100000000000001;100000000000001;100000000000001;100000000000002;100000000000002;100000000000002;100000000000002;100000000000002;100410000000002;1003F0000000001;100000000000001;100000000000001;100000000000001;100000000000001;100000000000001;100000000000001;100000000000001;100000000000001;100000000000002;100000000000002;100000000000002;100000000000002;100000000000002;100000000000002;100000000000002;100000000000002;100040000000002;100040000000002;100000000000001;100000000000001;100000000000001;100000000000001;100000000000001;100000000000001;100000000000001;100000000000001;100000000000001;100000000000001;100000000000001;100000000000001;100000000000001;100000000000001;100000000000001;100000000000001;100000000000001;100000000000001;100000000000001;100000000000001;100000000000001;100000000000001;100000000000001;100000000000001;100000000000002;100000000000002;100000000000002;100000000000002;100000000000002;100000000000002;100000000000002;100000000000002;100000000000002;100000000000001;100000000000001;100000000000001;100000000000001;100000000000001;100000000000002;100000000000001;100000000000001;100000000000001;100000000000002;100000000000002;100000000000002;100000000000002;100000000000002;100000000000002;100000000000001;100000000000001;100000000000001;100000000000001;100000000000001;100000000000001;100000000000001;100000000000001;100000000000001;100000000000001;100000000000001;100000000000001;100000000000001;100000000000001;100000000000001;100000000000001;100000000000001;100000000000001;100000000000002;100000000000002;100000000000002;100000000000002;100000000000002;100000000000002;100000000000002;100000000000002;100000000000002;100000000000001;100000000000001;100000000000001;100000000000001;100000000000001;100000000000001;100000000000001;100000000000001;100000000000001;
