100000000000001;100000000000001;100000000000001;100000000000001;100000000000001;100000000000001;100000000000001;100000000000001;100000000000001;100000000000001;100000000000001;100000000000001;100000000000001;100000000000001;100000000000001;100000000000001;100000000000001;100000000000001;100000000000001;100000000000001;100000000000001;100000000000001;100000000000001;100000000000001;100000000000001;100000000000001;100000000000001;100000000000001;100000000000001;100000000000001;100000000000001;100000000000001;100000000000001;100000000000001;100000000000001;100000000000001;100000000000001;100000000000001;
100000000000001;0;0;0;0;0;0;0;201000000000004;0;0;0;0;0;0;0;0;0;0;0;0;0;100000000000007;100000000000001;100000000000001;0;0;0;0;0;2D0000000000;2B0000000000;2B0000000000;2002B0000006403;2B0000000000;2002B0000006403;2B0000000000;100000000000001;
100000000000001;0;0;0;0;0;0;0;0;0;10000000000000C;0;0;0;0;0;0;290000000000;0;0;10000000000000A;0;0;100000000000001;100000000000001;20000000000000F;0;0;100000000006400;0;2002D0000006403;2B0000000000;2002B0000006400;2002B0000000007;2002B0000006400;2002B0000006400;2002B0000000000;100000000000001;
100000000000001;0;0;0;290000000000;0;0;0;0;290000000000;100000000000009;0;0;0;104000000000000;0;206000000000004;206280000000001;0;104000000000000;0;0;0;100000000000007;100000000000008;0;0;0;390000000000;0;2D0000000000;2B0000000000;1002B000000640F;1002B000000640F;1002B000000640F;1002B000000640F;1002B000000640F;100000000000001;
100000000000001;20100000000000F;103000000000000;0;201280000000001;0;0;203000000000004;0;201280000000001;100000000000018;0;104000000000000;10000000000000A;0;100000000000003;1003B0000000002;1003B0000000002;100000000000004;0;0;0;0;0;100000000000017;0;0;0;20038000000640C;200000000006400;1002B000000000C;1002B000000001C;1002B000000001C;1002B000000001C;1002B000000001C;1002B000000001C;1002B000000001C;100000000000001;
100000000000001;0;0;100000000000005;100000000000002;100000000000002;100000000000002;100000000000002;1002B0000000002;1002B0000000002;100000000000002;100000000000006;0;0;0;3C0000000000;3E0000000000;3E0000000000;3D0000000000;0;0;0;0;100000000000003;100000000000002;100000000000004;0;0;3A0000000000;200000000006400;100000000000007;100000000000002;100000000000002;100000000000002;100000000000002;100000000000002;100000000000002;100000000000001;
100000000000001;103000000000015;1002D000000000E;2B0000000000;2B0000000000;2B0000000000;1002B000000000E;2B0000000000;2B0000000000;2B0000000000;1002C000000000E;0;0;0;204000000000004;3C0000000000;3B0000000000;3B0000000000;3D0000000000;0;0;0;100000000000003;100000000000001;100000000000001;100000000000001;100000000000004;0;100000000006400;200000000006400;0;0;0;0;0;0;2B0000000000;100000000000001;
100000000000001;0;1002D000000000E;2042B0000000003;2042B0000000003;2B0000000000;1002B000000000E;2B0000000000;2042B0000000003;2042B0000000003;1002C000000000E;0;0;0;0;3C0000000000;3B0000000000;3B0000000000;3D0000000000;0;0;100000000000003;100000000000001;100000000000001;100000000000001;100000000000001;100000000000001;100000000000006;0;0;0;0;0;0;0;0;2B0000000000;100000000000001;
100000000000001;103000000000015;1002D000000000E;2042B0000000009;2042B0000000009;2042B0000000009;1002B000000000E;2042B0000000009;2042B0000000009;2042B0000000009;1002C000000000E;0;0;0;0;3C0000000000;3B0000000000;3003B0000000002;3D0000000000;0;0;100000000000001;2B0000000000;2002B0000000009;2002B0000000009;2B0000000000;1052C000000000E;10500000000000E;0;100000000000015;0;0;0;203000000006409;0;290000000000;2B0000000000;100000000000001;
100000000000001;0;100000000000005;100000000000002;100000000000002;1002B0000000002;100000000000002;100000000000002;100000000000002;100000000000002;100000000000004;0;0;100000000000003;100000000000002;100000000000002;100000000000002;100000000000002;100000000000002;100000000000002;100000000000002;100000000000001;2002B0000000000;2002B0000000000;2002B0000000000;2002B0000000003;1052C000000000E;10500000000000E;200000000000005;0;0;0;0;103000000006400;0;205280000000001;2B0000000000;100000000000001;
100000000000001;0;0;0;3C0000000000;3B0000000000;3B0000000000;3B0000000000;3E0000000000;3B0000000000;100000000000001;0;0;100000000000001;1D0000000000;1E0000000000;C0000000000;C0000000000;C0000000000;210000000000;220000000000;100000000000001;2002B0000000000;2002B0000000000;2002B0000000000;2002B0000000003;1052C000000000E;10500000000000E;100000000000015;0;0;0;0;390000000000;0;100000000000003;100000000000002;100000000000001;
100000000000001;103000000000015;0;0;3C0000000000;3B0000000000;3B0000000000;3B0000000000;3B0000000000;3B0000000000;100000000000001;10000000000001C;10000000000001C;100000000000001;1F0000000000;200000000000;C0000000000;C0000000000;C0000000000;230000000000;240000000000;100000000000001;100000000000002;100000000000002;100000000000002;100000000000002;100000000000002;100000000000004;0;0;203000000006404;0;103000000006400;380000000000;100000000000015;100000000000007;100000000000001;100000000000001;
100000000000001;0;0;202000000000004;3C0000000000;3B0000000000;2033B0000000001;3B0000000000;2023B0000000004;3B0000000000;100000000000001;100000000000002;100000000000002;100000000000001;C0000000000;2000C0000000000;C0000000000;3000C0000000001;C0000000000;2000C0000000000;C0000000000;100000000000001;100000000000001;0;0;3C0000000000;3B0000000000;1003B0000000001;100000000000002;100000000000002;100000000000002;100000000000004;0;380000000000;0;2D0000000000;100000000000001;100000000000001;
100000000000001;100000000000002;100000000000002;100000000000002;100000000000002;100000000000002;100000000000002;100000000000002;100000000000002;100000000000002;100000000000001;100000000000001;100000000000001;100000000000001;C0000000000;2000C0000000000;1000C0000000005;1000C0000000002;1000C0000000006;2000C0000000000;C0000000000;100000000000001;100000000000001;0;200000000000000;2003C0000000000;3B0000000000;1003B0000000001;100000000000001;100000000000001;100000000000001;100000000000008;0;380000000000;0;2D0000000000;1002D0000000007;100000000000001;
100000000000001;0;0;0;20000000000000B;0;0;0;100000000000007;100000000000001;100000000000001;100000000000001;100000000000001;100000000000001;C0000000000;2000C0000000000;150000000000;150000000000;150000000000;2000C0000000000;C0000000000;100000000000001;100000000000001;0;100000000000000;2003C0000000000;3B0000000000;1003B0000000009;1043D000000000E;10400000000000E;10400000000000E;0;0;380000000000;0;2D0000000000;2B0000000000;100000000000001;
100000000000001;0;0;0;0;0;0;0;0;0;201000000000004;0;0;100000000000001;210000000000;220000000000;C0000000000;C0000000000;C0000000000;1D0000000000;1E0000000000;100000000000001;100000000000001;0;390000000000;3C0000000000;3B0000000000;2003B0000000003;1043D000000000E;10400000000000E;10400000000000E;0;0;20538000000000C;0;2D0000000000;2B0000000000;100000000000001;
100000000000001;0;200000000000003;200000000000003;200000000000003;200000000000003;0;0;0;0;0;0;0;100000000000001;230000000000;240000000000;C0000000000;C0000000000;C0000000000;1F0000000000;200000000000;100000000000001;100000000000001;0;380000000000;3C0000000000;3B0000000000;2003B0000000003;1043D000000000E;10400000000000E;10400000000000E;0;205000000000004;2053A0000000004;0;2D0000000000;2052B0000000004;100000000000001;
100000000000001;0;100000000000015;100000000000015;100000000000015;100000000000015;0;0;0;200000000000000;200290000000000;200000000000000;0;100000000000001;100000000000002;100000000000002;100000000000004;430000000000;100000000000003;100000000000002;100000000000002;100000000000001;100000000000001;0;200380000000000;3C0000000000;3B0000000000;1003B0000000005;100000000000002;100000000000002;100000000000002;100000000000002;100000000000002;100000000000002;100000000000002;100000000000002;100000000000002;100000000000001;
100000000000001;0;0;0;0;0;0;10000000000000C;0;0;200280000000001;0;0;100000000000007;1003B0000000001;1003B0000000001;1003B0000000008;3B0000000000;100000000000007;100000000000001;100000000000001;100000000000001;100000000000001;0;380000000000;2043C0000000004;3B0000000000;3B0000000000;3B0000000000;3B0000000000;3B0000000000;2003B000000000B;3B0000000000;3B0000000000;3B0000000000;3B0000000000;3B0000000000;100000000000001;
100000000000001;100000000000015;100000000000015;0;103000000000000;100000000000015;100000000000015;100000000000001;100000000000015;100000000000015;100290000000015;100000000000015;0;3C0000000000;3B0000000000;3B0000000000;3B0000000000;3B0000000000;2003B0000000000;2003B0000000003;2003B0000000003;2003B0000000003;100000000000001;0;200380000000000;3C0000000000;3B0000000000;2003B000000000D;3B0000000000;3B0000000000;2003B0000000003;3B0000000000;2003B0000000003;3B0000000000;2003B0000000000;2003B0000000000;2003B0000000000;100000000000001;
100000000000001;0;0;0;390000000000;0;20000000000000E;100000000000001;0;0;203280000000001;0;203000000000004;3C0000000000;1003B000000000C;3B0000000000;3B0000000000;3B0000000000;2003B0000000000;2003B0000000003;1003B0000000003;100000000000002;100000000000001;0;20038000000000C;3C0000000000;3B0000000000;3B0000000000;3B0000000000;3B0000000000;3B0000000000;3B0000000000;3B0000000000;3B0000000000;2003B0000000000;2003B0000000000;2003B0000000000;100000000000001;
100000000000001;0;0;0;20338000000000C;0;0;100000000000001;100000000000002;100000000000002;100280000000002;100000000000002;100000000000002;1003C0000000002;1003B0000000001;1003B0000000004;3B0000000000;3B0000000000;2003B0000000000;100000000000003;100000000000001;100000000000001;100000000000001;0;3A0000000000;3C0000000000;1003B0000000015;3B0000000000;1003B000000000A;3B0000000000;1003B000000001B;3B0000000000;1003B000000001A;3B0000000000;1003B0000000015;1003B0000000015;3B0000000000;100000000000001;
100000000000001;0;10000000000000C;0;380000000000;0;0;100000000000001;100000000000001;100000000000001;100000000000001;100000000000001;100000000000001;100000000000001;100000000000001;1003B0000000001;1003B0000000004;2003B000000000A;100000000000003;100000000000001;100000000000001;100000000000001;100000000000001;0;100000000000000;3C0000000000;3B0000000000;3B0000000000;3B0000000000;3B0000000000;3B0000000000;3B0000000000;3B0000000000;3B0000000000;3B0000000000;2003B0000000001;2003B0000000006;100000000000001;
100000000000001;200000000000002;100000000000001;0;380000000000;0;0;100000000000007;100000000000001;100000000000001;100000000000001;100000000000001;100000000000001;100000000000001;100000000000001;100000000000001;100000000000001;100000000000002;100000000000001;100000000000001;100000000000001;100000000000001;100000000000001;0;0;3C0000000000;1003C000000000C;3B0000000000;3B0000000000;3B0000000000;3B0000000000;3B0000000000;3B0000000000;3B0000000000;3B0000000000;1003B0000000003;1003B0000000002;100000000000001;
100000000000001;0;100000000000001;0;3A0000000000;0;0;0;0;0;0;0;0;0;0;0;0;0;200000000000001;0;0;20500000000000E;100000000000009;0;0;1003C0000000015;1003C0000000001;3B0000000000;3B0000000000;2053B000000000A;3B0000000000;3B0000000000;3B0000000000;2053B000000000A;3B0000000000;1003B0000000001;100000000000001;100000000000001;
100000000000001;10000000000001C;100000000000001;0;103000000000000;0;100000000000003;100000000000002;100000000000004;0;100000000000003;100000000000002;100000000000004;0;100000000000003;100000000000002;100000000000004;0;100000000000003;100000000000002;100000000000004;0;0;0;205000000000004;3C0000000000;100000000000001;1003B000000001C;1003B000000001C;1003B000000000C;1003B000000001C;1002B000000001C;1003B000000001C;1002B000000000C;1002B000000001C;100000000000001;100000000000001;100000000000001;
100000000000001;100000000000001;100000000000001;100000000000002;100000000000002;100000000000002;100000000000001;100000000000001;100000000000001;100000000000002;100000000000001;100000000000001;100000000000001;100000000000002;100000000000001;100000000000001;100000000000001;100000000000002;100000000000001;100000000000001;100000000000001;100000000000002;100000000000002;100000000000002;100000000000002;100000000000002;100000000000001;100000000000001;100000000000001;100000000000001;1002B0000000001;1002B0000000001;1002B0000000001;100000000000001;100000000000001;100000000000001;100000000000001;100000000000001;
